阿	a
不	b
此	c
的	d
而	e
发	f
个	g
和	h
是	i
就	j
可	k
了	l
们	m
你	n
哦	o
平	p
其	q
人	r
所	s
他	t
这	u
出	v
我	w
下	x
一	y
在	z
啊	aa
爱	ai
安	an
奥	ao
把	ba
保	bc
白	bd
本	bg
比	bi
边	bj
般	bl
表	bm
博	bo
贝	bp
别	bt
部	bu
宾	bx
并	by
擦	ca
草	cc
才	cd
测	ce
凑	cf
仓	ch
词	ci
存	ck
参	cl
错	co
从	cs
粗	cu
层	cz
大	da
到	dc
带	dd
德	de
都	df
当	dh
地	di
点	dj
顿	dk
但	dl
掉	dm
多	do
断	dr
动	ds
跌	dt
独	du
对	dv
定	dy
等	dz
恶	ee
恩	en
儿	er
法	fa
分	fg
方	fh
反	fl
佛	fo
非	fp
富	fu
风	fz
嘎	ga
高	gc
该	gd
各	ge
够	gf
跟	gg
刚	gh
滚	gk
感	gl
过	go
给	gp
光	gq
官	gr
共	gs
古	gu
鬼	gv
挂	gw
怪	gy
更	gz
哈	ha
好	hc
海	hd
何	he
后	hf
很	hg
混	hk
汗	hl
或	ho
黑	hp
黄	hq
还	hr
红	hs
乎	hu
会	hv
话	hw
怀	hy
横	hz
杀	ia
少	ic
射	ie
手	if
神	ig
上	ih
事	ii
顺	ik
山	il
说	io
谁	ip
双	iq
数	iu
水	iv
刷	iw
帅	iy
声	iz
觉	jg
几	ji
见	jj
军	jk
叫	jm
九	jn
将	jq
卷	jr
界	jt
聚	ju
家	jw
进	jx
经	jy
卡	ka
靠	kc
开	kd
科	ke
口	kf
肯	kg
康	kh
困	kk
看	kl
括	ko
况	kq
宽	kr
空	ks
苦	ku
亏	kv
夸	kw
快	ky
坑	kz
拉	la
老	lc
来	ld
乐	le
楼	lf
略	lg
浪	lh
立	li
脸	lj
论	lk
兰	ll
料	lm
留	ln
罗	lo
类	lp
两	lq
乱	lr
龙	ls
烈	lt
路	lu
绿	lv
俩	lw
林	lx
灵	ly
冷	lz
马	ma
毛	mc
买	md
么	me
某	mf
门	mg
忙	mh
米	mi
面	mj
漫	ml
妙	mm
没	mo
美	mp
灭	mt
目	mu
民	mx
明	my
猛	mz
那	na
脑	nc
呢	ne
虐	ng
囊	nh
泥	ni
年	nj
难	nl
鸟	nm
牛	nn
诺	no
内	np
娘	nq
暖	nr
弄	ns
怒	nu
女	nv
您	nx
宁	ny
能	nz
欧	ou
怕	pa
跑	pc
拍	pd
剖	pf
喷	pg
旁	ph
皮	pi
片	pj
盘	pl
飘	pm
破	po
配	pp
撇	pt
普	pu
品	px
凭	py
朋	pz
却	qg
起	qi
前	qj
群	qk
巧	qm
球	qn
强	qq
全	qr
穷	qs
切	qt
去	qu
亲	qx
情	qy
热	re
肉	rf
认	rg
让	rh
日	ri
润	rk
然	rl
若	ro
软	rr
容	rs
如	ru
瑞	rv
仍	rz
萨	sa
扫	sc
赛	sd
色	se
私	si
孙	sk
三	sl
索	so
算	sr
送	ss
速	su
虽	sv
她	ta
逃	tc
太	td
特	te
头	tf
唐	th
体	ti
天	tj
吞	tk
谈	tl
条	tm
拖	to
团	tr
同	ts
铁	tt
土	tu
退	tv
听	ty
腾	tz
炸	ua
招	uc
着	ue
周	uf
真	ug
张	uh
纸	ui
准	uk
战	ul
桌	uo
装	uq
转	ur
中	us
主	uu
追	uv
抓	uw
正	uz
差	va
朝	vc
车	ve
丑	vf
沉	vg
厂	vh
吃	vi
产	vl
传	vr
处	vu
吹	vv
成	vz
瓦	wa
外	wd
问	wg
王	wh
完	wl
握	wo
为	wp
五	wu
学	xg
西	xi
现	xj
寻	xk
小	xm
修	xn
想	xq
选	xr
兄	xs
些	xt
许	xu
吓	xw
心	xx
行	xy
亚	ya
要	yc
也	ye
有	yf
月	yg
样	yh
以	yi
云	yk
烟	yl
原	yr
用	ys
与	yu
因	yx
应	yy
杂	za
早	zc
再	zd
则	ze
走	zf
怎	zg
子	zi
尊	zk
赞	zl
做	zo
总	zs
阻	zu
最	zv
曾	zz
拜	ag
抱	ab
持	ac
换	ad
承	ae
排	af
打	ah
折	aj
抛	al
挥	am
投	ap
挤	aq
指	ar
挨	as
抽	at
摸	au
拿	av
撒	aw
掌	ax
报	ay
摇	az
冰	be
疯	bf
百	bh
宴	bn
次	bq
宣	br
包	bs
货	bv
宝	bw
室	bz
蛇	cb
轻	cg
御	cj
循	cm
长	cp
厌	cq
得	cr
压	ct
徐	cv
微	cw
辅	cy
死	db
划	dg
制	dn
失	dp
刘	dw
争	dx
浙	ea
演	eb
源	ec
注	ed
游	ef
江	eg
二	eh
深	ei
渐	ej
消	el
泪	em
河	eo
波	ep
清	eq
活	es
油	et
满	eu
池	ev
激	ew
沙	ex
汉	ey
滩	ez
约	fb
阵	fc
防	ff
纪	fj
陆	fk
继	fm
素	fq
阳	fr
族	fs
细	ft
飞	fv
绕	fw
店	gb
床	gi
既	gj
魔	gm
威	gn
座	gt
灰	hh
虎	hj
且	ht
秒	hx
松	ib
术	id
机	ij
相	im
查	ir
标	is
果	it
档	ix
斯	jb
触	jc
京	jd
帮	jf
卫	jh
师	jl
铅	jo
斤	jp
视	js
锋	jz
管	kb
策	ki
笔	km
竹	kp
哀	kt
凶	kx
办	lb
益	mb
农	mk
精	mq
盟	mr
母	mv
重	mw
物	nb
妖	nd
娜	nf
娃	nt
牧	nw
啦	oa
只	ob
吴	od
喊	og
号	oh
呆	oi
嘴	oj
商	ol
吗	om
告	on
响	oo
呼	op
器	oq
喝	or
吧	os
吐	ot
合	ov
名	ox
善	oy
售	oz
屁	pb
尿	pe
展	pk
尽	pn
砍	pq
千	ps
久	pv
狗	qb
酬	qc
静	qd
青	qh
猪	ql
歌	qo
欠	qp
猴	qv
狂	qw
酸	qz
易	rb
时	rc
晚	rd
景	rj
晕	rm
入	rp
晴	rq
雷	rt
晓	rw
雪	rx
暗	ry
密	sb
罪	sf
十	sh
岛	sn
食	sp
饮	sq
直	st
岁	sx
须	sy
六	tb
城	tg
坡	tp
堂	tx
菊	ub
英	ud
节	uj
蓝	um
董	up
艾	ux
芽	uy
化	vb
住	vd
佩	vj
依	vk
件	vn
使	vo
假	vp
伏	vq
什	vs
停	vt
伟	vw
伊	vx
信	vy
瓶	wb
四	we
放	wf
珠	wi
改	wj
敌	ws
效	wt
收	wv
国	ww
整	wz
懒	xb
愿	xc
忍	xd
率	xe
悲	xf
愁	xh
归	xl
香	xp
忆	xv
息	xz
言	yd
记	yj
设	yp
请	yq
变	yt
警	yw
受	yz
字	zb
至	zh
近	zj
迷	zm
自	zp
臭	zq
遭	zr
备	zt
邀	zw
步	zx
雅	zy
阴	fx
止	hb
克	kj
向	oc
犯	qe
型	tq
园	wm
限	fn
兵	bb
厦	cx
渴	ek
嗯	oe
呵	ok
救	wq
被	bk
电	dq
洪	hn
加	ja
济	je
己	jv
妈	mn
梦	ms
嫩	nk
道	ow
爬	pr
缺	qf
旦	ra
树	sm
填	tn
它	tw
万	wn
忘	wx
文	wy
笑	xa
元	yb
页	ym
音	yn
已	yv
钻	zn
式	sz
副	fd
盒	hm
睡	vm
费	fe
锦	gx
生	sg
随	sw
又	yo
枪	ak
华	cn
鱼	fi
嗨	hi
里	in
刀	kn
关	of
量	pw
质	qa
雨	rn
联	un
厕	wc
星	wk
世	wr
酒	xo
极	sj
无	ut
译	fy
阿	aaf
锕	aaj
錒	aajm
腌	aal
啊	aao
呵	aaob
嗄	aaoc
吖	aaod
醃	aaqm
骯	aggm
枊	agim
卬	agjm
肮	agl
盎	agm
醠	agqm
昂	agr
昻	agrm
岇	agsm
挨	aia
捱	aiab
癌	aib
皑	aibb
皚	aibm
凒	aibn
賹	aibo
皧	aibp
溾	aiem
溰	aien
濭	aieo
隘	aif
阨	aifm
隑	aifn
絠	aifo
焥	aihm
锿	aij
鎄	aijm
鑀	aijn
哀	aik
毐	aimm
騃	aimn
瞹	aimo
嫒	ain
嬡	ainm
娭	ainn
娾	aino
鴱	ainp
唉	aio
哎	aiob
呆	aioc
嗳	aiod
嗌	aioe
噯	aiom
啀	aion
嘊	aioo
碍	aip
砹	aipb
礙	aipm
硙	aipn
硋	aipo
磑	aipp
欬	aiqm
欸	aiqn
霭	air
暧	airb
靄	airm
曖	airn
昹	airo
靉	airp
矮	ais
嵦	aism
叆	aisn
躷	aiso
餲	aisp
埃	ait
堨	aitm
塧	aitn
壒	aito
艾	aiu
蔼	aiub
藹	aium
薆	aiun
伌	aivm
佁	aivn
僾	aivo
瑷	aiw
璦	aiwm
敱	aiwn
敳	aiwo
愛	aixm
懓	aixn
懝	aixo
馤	aixp
誒	aiym
諰	aiyn
譪	aiyo
譺	aiyp
鱫	aiyq
爱	aiz
按	ana
揞	anab
安	anb
痷	anbm
厂	anc
厈	ancm
洝	anem
隌	anfm
鞍	ang
庵	angb
广	angc
鞌	angm
黯	anh
案	ani
桉	anib
铵	anj
銨	anjm
錌	anjn
裺	ankm
胺	anl
腤	anlm
盦	anmm
闇	anmn
盫	anmo
鹌	ann
鵪	annm
婩	annn
媕	anno
鶕	annp
咹	anom
唵	anon
啽	anoo
氨	anq
犴	anqb
暗	anr
晻	anrm
雸	anrn
岸	ans
屵	ansm
屽	ansn
峖	anso
罯	ansp
埯	ant
垵	antm
堓	antn
荌	anum
菴	anun
葊	anuo
萻	anup
蓭	anuq
俺	anv
侒	anvm
偣	anvn
儑	anvo
玵	anwm
馣	anxm
谙	any
諳	anym
誝	anyn
鮟	anyo
韽	anyp
豻	anzm
貋	anzn
拗	aoa
扷	aoam
抝	aoan
摮	aoao
擙	aoap
螯	aoc
镺	aocm
軪	aocn
厫	aoco
奥	aod
奧	aodm
奡	aodn
澳	aoe
泑	aoem
滶	aoen
澚	aoeo
聱	aof
郩	aofm
隞	aofn
隩	aofo
廒	aog
熬	aoh
熝	aohm
爊	aohn
柪	aoim
梎	aoin
鏊	aoj
凹	aok
袄	aokb
襖	aokm
鏖	aol
骜	aom
驁	aomm
眑	aomn
鼇	aomo
媪	aon
媼	aonm
嫯	aonn
鷔	aono
嗷	aoo
囂	aoom
嗸	aoon
磝	aopm
獒	aoq
獓	aoqm
岙	aos
嶴	aosm
岰	aosn
嶅	aoso
坳	aot
垇	aotm
墺	aotn
艹	aou
芺	aoum
蔜	aoun
傲	aov
敖	aow
璈	aowm
懊	aox
慠	aoxm
翱	aoy
鳌	aoyb
翺	aoym
鰲	aoyn
謷	aoyo
翶	aoyp
謸	aoyq
遨	aoz
把	baa
拔	baab
扒	baac
捌	baad
抜	baam
扷	baan
八	bab
疤	babb
丷	babm
皅	babn
癹	babo
蚆	bacm
軷	bacn
夿	badm
灞	bae
爸	baf
颰	bafm
靶	bag
魃	bagb
弝	bagm
炦	bahm
朳	baim
柭	bain
欛	baio
钯	baj
鈀	bajm
釟	bajn
釛	bajo
笆	bak
耙	bal
胈	balm
粑	bam
妭	banm
吧	bao
叭	baob
巼	baom
哱	baon
哵	baoo
霸	bar
巴	bas
罢	basb
岜	basc
罷	basm
峇	basn
豝	baso
鼥	basp
矲	basq
坝	bat
壩	batm
垻	batn
芭	bau
茇	baub
菝	bauc
仈	bavm
玐	bawm
覇	baxm
鲅	bay
鮁	baym
犮	bayn
叐	bayo
羓	bayp
鲃	bayq
詙	bayr
鲌	bays
魞	bayt
鮊	bayu
跋	baz
跁	bazm
报	bca
抱	bcab
包	bcb
宝	bcbb
宀	bcbc
勹	bcbd
寶	bcbm
勽	bcbn
宲	bcbo
寚	bcbp
髱	bcbq
賲	bcbr
寳	bcbs
龅	bcc
齙	bccm
蚫	bccn
忁	bcco
剥	bcd
刨	bcdb
剝	bcdm
瀑	bce
緥	bcfm
骲	bcgm
爆	bch
炮	bchb
煲	bchc
虣	bchm
枹	bcim
铇	bcjm
鉋	bcjn
鑤	bcjo
褒	bck
褓	bckb
笣	bckm
袌	bckn
裦	bcko
襃	bckp
胞	bcl
靤	bcmm
駂	bcmn
闁	bcmo
鸨	bcn
鴇	bcnm
媬	bcnn
鳵	bcno
犦	bcnp
嚗	bcom
犳	bcqm
暴	bcr
曝	bcrb
雹	bcrc
曓	bcrm
靌	bcrn
饱	bcs
飽	bcsm
飹	bcsn
堡	bct
報	bctm
堢	bctn
薄	bcu
苞	bcub
葆	bcuc
菢	bcum
蕔	bcun
藵	bcuo
保	bcv
佨	bcvm
儤	bcvn
珤	bcwm
怉	bcxm
窇	bcxn
鲍	bcy
鮑	bcym
豹	bcz
孢	bczb
趵	bczc
摆	bda
拜	bdab
掰	bdac
捭	bdad
擘	bdae
擺	bdam
拝	bdan
挀	bdao
白	bdb
百	bdbb
败	bdbc
贁	bdbm
絔	bdfm
庍	bdgm
稗	bdh
柏	bdi
栢	bdim
兡	bdkm
襬	bdkn
竡	bdlm
粨	bdmm
粺	bdmn
犤	bdnm
呗	bdo
唄	bdom
猈	bdqm
薭	bdum
伯	bdv
佰	bdvb
敗	bdwm
瓸	bdwn
韛	bdwo
捹	bgam
撪	bgan
贲	bgb
賁	bgbm
蟦	bgcm
奔	bgd
夯	bgdb
夲	bgdm
奙	bgdn
泍	bgem
渀	bgen
漰	bgeo
體	bggm
炃	bghm
本	bgi
栟	bgim
桳	bgin
楍	bgio
锛	bgj
錛	bgjm
笨	bgk
犇	bgnm
喯	bgom
坌	bgt
畚	bgtb
坋	bgtm
苯	bgu
倴	bgvm
翉	bgym
逩	bgzm
挷	bham
捠	bhan
搒	bhao
蚌	bhc
蚄	bhcm
蛖	bhcn
蜯	bhco
浜	bhe
邦	bhf
绑	bhfb
旁	bhfc
綁	bhfm
邫	bhfn
縍	bhfo
鞤	bhgm
髈	bhgn
稖	bhhm
棒	bhi
榜	bhib
梆	bhic
棓	bhim
帮	bhj
镑	bhjb
幫	bhjm
鎊	bhjn
幇	bhjo
幚	bhjp
膀	bhl
磅	bhp
硥	bhpm
牓	bhpn
峀	bhsm
垹	bhtm
塝	bhtn
蒡	bhu
傍	bhv
玤	bhwm
谤	bhy
謗	bhym
艕	bhzm
比	bib
毕	bibb
鼻	bibc
匕	bibd
毙	bibe
痹	bibf
贲	bibg
毖	bibh
賁	bibm
匂	bibn
皀	bibo
疕	bibp
疪	bibq
皕	bibr
貱	bibs
赑	bibt
痺	bibu
髲	bibv
贔	bibw
彼	bic
蜌	bicm
螕	bicn
夶	bidm
豍	bidn
奰	bido
泌	bie
濞	bieb
滗	biec
潷	biem
沘	bien
湢	bieo
滭	biep
鄙	bif
陛	bifb
紕	bifm
邲	bifn
旇	bifo
紴	bifp
聛	bifq
鄪	bifr
綼	bifs
縪	bift
鄨	bifu
繴	bifv
弊	big
庇	bigb
弼	bigc
髀	bigd
庳	bige
弻	bigm
彃	bign
廦	bigo
鞞	bigp
鞸	bigq
魓	bigr
秘	bih
秕	bihb
煏	bihm
稫	bihn
熚	biho
朼	biim
柲	biin
柀	biio
梐	biip
楅	biiq
榌	biir
币	bij
铋	bijb
幣	bijm
鉍	bijn
幤	bijo
觱	bijp
鏎	bijq
鎞	bijr
鐴	bijs
笔	bik
裨	bikb
篦	bikc
筚	bikd
箅	bike
襞	bikf
筆	bikm
篳	bikn
笓	biko
袐	bikp
箆	bikq
箄	bikr
襅	biks
襣	bikt
臂	bil
肶	bilm
胇	biln
腷	bilo
闭	bim
睥	bimb
閉	bimm
闬	bimn
毞	bimo
粊	bimp
粃	bimq
閈	bimr
閇	bims
毴	bimt
睤	bimu
閟	bimv
駜	bimw
驆	bimx
鼊	bimy
婢	bin
妣	binb
嬖	binc
妼	binm
娝	binn
嬶	bino
鵖	binp
鶝	binq
鷝	binr
鷩	bins
哔	bio
吡	biob
嗶	biom
咇	bion
啚	bioo
碧	bip
屄	bipm
狴	biq
獙	biqm
獘	biqn
朇	birm
祕	bism
崥	bisn
禆	biso
飶	bisp
罼	bisq
饆	bisr
壁	bit
畀	bitb
畢	bitm
坒	bitn
畁	bito
畐	bitp
堛	bitq
蔽	biu
薜	biub
荜	biuc
蓖	biud
芘	biue
萆	biuf
荸	biug
蓽	bium
苾	biun
萞	biuo
俾	biv
佖	bivm
佊	bivn
偪	bivo
璧	biw
敝	biwb
斃	biwm
珌	biwn
韠	biwo
必	bix
辟	bixb
愎	bixc
怭	bixm
怶	bixn
愊	bixo
馝	bixp
诐	biym
翍	biyn
詖	biyo
鮅	biyp
鲾	biyq
鰏	biyr
避	biz
逼	bizb
跸	bizc
舭	bizd
蹕	bizm
迊	bizn
貏	bizo
躃	bizp
躄	bizq
抃	bjam
揙	bjan
贬	bjb
髟	bjbb
貶	bjbm
疺	bjbn
蝙	bjc
釆	bjcm
徧	bjcn
卞	bjd
豍	bjdm
汴	bje
汳	bjem
编	bjf
匾	bjfb
缏	bjfc
編	bjfm
緶	bjfn
鞭	bjg
弁	bjgb
鞕	bjgm
扁	bjh
煸	bjhb
炞	bjhm
稨	bjhn
覍	bjjm
鍽	bjjn
覵	bjjo
笾	bjk
褊	bjkb
籩	bjkm
箯	bjkn
籓	bjko
閞	bjmm
糄	bjmn
鴘	bjnm
鶣	bjnn
砭	bjp
碥	bjpb
牑	bjpm
猵	bjqm
獱	bjqn
昪	bjrm
峅	bjsm
苄	bju
萹	bjum
藊	bjun
便	bjv
玣	bjwm
甂	bjwn
辩	bjx
辨	bjxb
辫	bjxc
忭	bjxd
窆	bjxe
辮	bjxm
辯	bjxn
惼	bjxo
辡	bjxp
辧	bjxq
变	bjy
鳊	bjyb
變	bjym
鯿	bjyn
諚	bjyo
鯾	bjyp
边	bjz
遍	bjzb
邊	bjzm
辺	bjzn
変	bjzo
臱	bjzp
艑	bjzq
邉	bjzr
兺	bkbm
搬	bla
扮	blab
拌	blac
扳	blad
搫	blam
半	blb
瘢	blbb
癍	blbc
蝂	blcm
螁	blcn
螌	blco
湴	blem
绊	blf
阪	blfb
絆	blfm
靽	blgm
秚	blhm
板	bli
柈	blim
钣	blj
鈑	bljm
鉡	bljn
褩	blkm
办	bll
朌	bllm
肦	blln
粄	blmm
闆	blmn
姅	blnm
鳻	blnn
版	blp
昄	blrm
岅	blsm
坂	blt
坢	bltm
伴	blv
班	blw
斑	blwb
瓪	blwm
攽	blwn
斒	blwo
瓣	blx
辦	blxm
怑	blxn
辬	blxo
颁	bly
頒	blym
魬	blyn
般	blz
舨	blzb
跘	blzm
摽	bmam
髟	bmb
瘭	bmbb
贆	bmbm
淲	bmem
滮	bmen
瀌	bmeo
飙	bmf
飚	bmfb
飑	bmfc
飆	bmfm
飈	bmfn
颮	bmfo
颩	bmfp
颷	bmfq
飇	bmfr
飊	bmfs
灬	bmh
熛	bmhm
爂	bmhn
穮	bmho
标	bmi
杓	bmib
標	bmim
檦	bmin
镖	bmj
镳	bmjb
鏢	bmjm
鑣	bmjn
幖	bmjo
鋲	bmjp
錶	bmjq
表	bmk
裱	bmkb
褾	bmkm
篻	bmkn
膘	bml
脿	bmlm
膔	bmln
麃	bmlo
臕	bmlp
骠	bmm
驃	bmmm
骉	bmmn
驫	bmmo
婊	bmn
嫑	bmnm
磦	bmpm
猋	bmqm
彪	bms
墂	bmtm
蔈	bmum
藨	bmun
俵	bmvm
僄	bmvn
儦	bmvo
鳔	bmy
鰾	bmym
諘	bmyn
謤	bmyo
播	boa
搏	boab
拨	boac
擘	boad
撥	boam
挬	boan
卜	bob
魄	bobb
癶	bobm
皪	bobn
彴	bocm
蚾	bocn
剥	bod
剝	bodm
殕	bodn
波	boe
泊	boeb
渤	boec
浡	boem
淿	boen
溊	boeo
缽	bofm
郣	bofn
紴	bofo
瓝	bogm
瓟	bogn
髆	bogo
髉	bogp
秡	bohm
煿	bohn
穛	boho
柏	boi
檗	boib
柭	boim
栢	boin
桲	boio
榑	boip
檘	boiq
欂	boir
钵	boj
帛	bojb
钹	bojc
铂	bojd
鉑	bojm
鈸	bojn
鉢	bojo
镈	bojp
鋍	bojq
鎛	bojr
鑮	bojs
箔	bok
簸	bokb
袯	bokm
袹	bokn
襏	boko
簙	bokp
襮	bokq
脖	bol
勃	bolb
膊	bolc
肑	bolm
胉	boln
驳	bom
駁	bomm
盋	bomn
駮	bomo
糪	bomp
驋	bomq
鹁	bon
鵓	bonm
犦	bonn
啵	boo
哱	boom
噃	boon
嚗	booo
礴	bop
砵	bopm
碆	bopn
牔	bopo
磻	bopp
礡	bopq
狛	boqm
猼	boqn
博	bos
饽	bosb
餑	bosm
馎	bosn
嶓	boso
餺	bosp
亳	bot
壆	botm
薄	bou
菠	boub
蔔	boum
蘗	boun
苩	bouo
萡	boup
葧	bouq
伯	bov
仢	bovm
侼	bovn
僰	bovo
僠	bovp
玻	bow
愽	boxm
馛	boxn
馞	boxo
懪	boxp
詙	boym
鲌	boyn
誖	boyo
鮊	boyp
謈	boyq
譒	boyr
鱍	boys
舶	boz
跛	bozb
孛	bozc
踣	bozd
艊	bozm
孹	bozn
蹳	bozo
揹	bpam
北	bpb
贝	bpbb
貝	bpbm
辈	bpc
輩	bpcm
軰	bpcn
蛽	bpco
陂	bpf
邶	bpfb
郥	bpfm
鄁	bpfn
鞴	bpg
庳	bpgb
鞁	bpgm
骳	bpgn
鞞	bpgo
焙	bph
杯	bpi
杮	bpim
柸	bpin
桮	bpio
梖	bpip
棑	bpiq
椑	bpir
棓	bpis
钡	bpj
鐾	bpjb
鋇	bpjm
鉳	bpjn
被	bpk
褙	bpkb
箄	bpkm
襬	bpkn
背	bpl
臂	bplb
盃	bpmm
糒	bpmn
鹎	bpn
鵯	bpnm
牬	bpnn
犕	bpno
呗	bpo
唄	bpom
碑	bpp
碚	bppb
狈	bpq
狽	bpqm
昁	bprm
卑	bps
禙	bpsm
蓓	bpu
苝	bpum
藣	bpun
倍	bpv
備	bpvm
俻	bpvn
偝	bpvo
偹	bpvp
僃	bpvq
珼	bpwm
琲	bpwn
悲	bpx
惫	bpxb
悖	bpxc
憊	bpxm
愂	bpxn
誖	bpym
諀	bpyn
备	bpz
孛	bpzb
瘪	btb
癟	btbm
蛂	btcm
徶	btcn
蟞	btco
别	btd
別	btdm
彆	btgm
龞	btgn
柭	btim
柲	btin
襒	btkm
鼈	btmm
咇	btom
莂	btum
虌	btun
憋	btx
鳖	bty
鱉	btym
蹩	btz
捕	bua
抪	buam
捗	buan
捬	buao
卜	bub
轐	bucm
部	buf
郶	bufm
巭	bugm
庯	bugn
廍	bugo
不	buh
柨	buim
布	buj
钚	bujb
钸	bujc
鈈	bujm
鈽	bujn
錻	bujo
补	buk
簿	bukb
補	bukm
箁	bukn
篰	buko
勏	bulm
婄	bunm
鳪	bunn
鵏	buno
鸔	bunp
卟	buo
哺	buob
吥	buom
咘	buon
醭	buq
晡	bur
峬	busm
餔	busn
餢	buso
埠	but
埔	butb
堡	butc
埗	butm
蔔	buum
荹	buun
蔀	buuo
佈	buvm
瓿	buw
怖	bux
悑	buxm
誧	buym
鯆	buyn
步	buz
逋	buzb
歨	buzm
歩	buzn
踄	buzo
摈	bxa
擯	bxam
宾	bxb
鬓	bxbb
賓	bxbm
鬢	bxbn
髩	bxbo
賔	bxbp
鬂	bxbq
蠙	bxcm
殡	bxd
殯	bxdm
滨	bxe
濒	bxeb
濱	bxem
瀕	bxen
汃	bxeo
濵	bxep
缤	bxf
繽	bxfm
邠	bxfn
髌	bxg
髕	bxgm
虨	bxhm
槟	bxi
檳	bxim
梹	bxin
椕	bxio
镔	bxj
鑌	bxjm
膑	bxl
臏	bxlm
砏	bxpm
霦	bxrm
彬	bxs
豳	bxsb
豩	bxsm
傧	bxv
儐	bxvm
斌	bxw
玢	bxwb
瑸	bxwm
璸	bxwn
頻	bxym
顮	bxyn
摒	bya
抦	byam
掤	byan
兵	byb
并	bybb
冰	bybc
病	bybd
冫	bybe
並	bybm
寎	bybn
蛃	bycm
氷	byem
邴	byf
綆	byfm
陃	byfn
絣	byfo
幷	bygm
庰	bygn
鞆	bygo
鞞	bygp
鞸	bygq
秉	byh
炳	byhb
丙	byhc
稟	byhm
柄	byi
槟	byib
檳	byim
栤	byin
栟	byio
梹	byip
棅	byiq
鈵	byjm
鉼	byjn
鋲	byjo
竝	bylm
眪	bymm
屏	byp
屛	bypm
昞	byrm
昺	byrn
靐	byro
饼	bys
禀	bysb
餅	bysm
餠	bysn
垪	bytm
苪	byum
仌	byvm
仒	byvn
併	byvo
倂	byvp
偋	byvq
傡	byvr
琕	bywm
怲	byxm
窉	byxn
誁	byym
鮩	byyn
揼	bzam
痭	bzbm
蚌	bzc
蜯	bzcm
奟	bzdm
泵	bze
绷	bzf
繃	bzfm
絣	bzfn
綳	bzfo
鞛	bzgm
镚	bzjm
鏰	bzjn
閍	bzmm
嘣	bzo
嗙	bzom
崩	bzs
祊	bzsm
嵭	bzsn
埄	bztm
埲	bztn
塴	bzto
菶	bzum
伻	bzvm
甏	bzw
琫	bzwm
琣	bzwn
甭	bzy
甮	bzym
蹦	bzz
迸	bzzb
逬	bzzm
跰	bzzn
擦	caa
拆	caab
攃	caam
嚓	cao
囃	caom
礤	cap
礸	capm
遪	cazm
操	cca
撡	ccam
螬	ccc
漕	cce
鄵	ccfm
鼜	ccgm
槽	cci
鏪	ccjm
鏕	ccjn
褿	cckm
襙	cckn
屮	ccl
糙	ccm
騲	ccmm
嘈	cco
曹	ccr
肏	ccrm
曺	ccrn
嶆	ccsm
墽	cctm
草	ccu
艹	ccub
艸	ccum
蓸	ccun
傮	ccvm
愺	ccxm
慅	ccxn
慒	ccxo
懆	ccxp
艚	ccz
扐	cdam
採	cdan
揌	cdao
财	cdb
財	cdbm
宷	cdbn
寀	cdbo
采	cdc
綵	cdfm
縩	cdfn
纔	cdfo
戝	cdgm
才	cdh
材	cdi
棌	cdim
裁	cdk
睬	cdm
婇	cdnm
啋	cdom
猜	cdq
彩	cds
埰	cdtm
菜	cdu
蔡	cdub
倸	cdvm
偲	cdvn
踩	cdz
跴	cdzm
拺	ceam
厕	cec
厠	cecm
夨	cedm
测	cee
測	ceem
廁	cegm
策	cek
笧	cekm
筴	cekn
筞	ceko
箣	cekp
簎	cekq
粣	cemm
册	cep
冊	cetm
畟	cetn
荝	ceum
萗	ceun
萴	ceuo
蓛	ceup
侧	cev
側	cevm
敇	cewm
恻	cex
惻	cexm
憡	cexn
凑	cfb
辏	cfc
輳	cfcm
湊	cfem
楱	cfi
腠	cfl
傶	cfvm
玼	cfwm
涔	cge
汵	cgem
穇	cghm
梣	cgim
笒	cgkm
篸	cgkn
参	cgs
岑	cgsb
參	cgsm
叄	cgsn
叅	cgso
嵾	cgsp
埁	cgtm
凔	chbm
賶	chbn
螥	chcm
沧	che
滄	chem
濸	chen
匨	chfm
臧	chg
欌	chim
鑶	chjm
篬	chkm
鸧	chnm
鶬	chnn
獊	chqm
嵢	chsm
藏	chu
苍	chub
蒼	chum
仓	chv
伧	chvb
倉	chvm
傖	chvn
仺	chvo
玱	chwm
瑲	chwn
舱	chz
艙	chzm
赐	cib
兹	cibb
疵	cibc
賜	cibm
皉	cibn
蛓	cicm
螆	cicn
蠀	cico
齹	cicp
刺	cid
刾	cidm
泚	ciem
濨	cien
絘	cifm
縒	cifn
差	cig
庛	cigm
骴	cign
髊	cigo
朿	ciim
柌	ciin
栨	ciio
糍	cim
鹚	cin
鶿	cinm
嬨	cinn
鴜	cino
鷀	cinp
呰	ciom
啙	cion
磁	cip
礠	cipm
次	ciq
祠	cis
飺	cism
餈	cisn
垐	citm
茨	ciu
茈	ciub
茦	cium
莿	ciun
薋	ciuo
伺	civ
乲	civm
佌	civn
佽	civo
偨	civp
瓷	ciw
珁	ciwm
玼	ciwn
甆	ciwo
辞	cix
慈	cixb
辭	cixm
辝	cixn
辤	cixo
词	ciy
詞	ciym
鮆	ciyn
此	ciz
雌	cizb
趀	cizm
跐	cizn
拵	ckam
寸	ckc
刌	ckdm
澊	ckem
邨	ckfm
村	cki
竴	cklm
籿	ckmm
吋	ckom
皴	ckp
膥	ckrm
墫	cktm
侟	ckvm
忖	ckx
存	ckz
蹲	ckzb
踆	ckzm
摻	clam
摲	clan
蚕	clc
蠶	clcm
蝅	clcn
蠺	clco
残	cld
殘	cldm
湌	clem
澯	clen
灿	clh
黪	clhb
燦	clhm
黲	clhn
穇	clho
爘	clhp
鏒	cljm
篸	clkm
粲	clm
骖	clmb
驂	clmm
嬠	clnm
喰	clom
嘇	clon
囋	cloo
孱	clp
朁	clrm
参	cls
餐	clsb
參	clsm
飡	clsn
叄	clso
叅	clsp
飱	clsq
薒	clum
傪	clvm
儏	clvn
璨	clw
惨	clx
惭	clxb
慚	clxm
慘	clxn
慙	clxo
憯	clxp
謲	clym
措	coa
搓	coab
挫	coac
撮	coad
痤	cob
瘥	cobb
厝	coc
齹	cocm
剉	codm
剒	codn
縒	cofm
酂	cofn
酇	cofo
庴	cogm
髊	cogn
虘	cohm
棤	coim
错	coj
锉	cojb
錯	cojm
銼	cojn
鎈	cojo
鹾	col
脞	colb
鹺	colm
睉	comm
磋	cop
醝	coqm
嵯	cos
矬	cosb
嵳	cosm
莡	coum
莝	coun
蒫	couo
蓌	coup
蔖	couq
瑳	cowm
諎	coym
蹉	coz
夎	cozm
逪	cozn
遳	cozo
攒	cra
撺	crab
攢	cram
攛	cran
攅	crao
殩	crdm
汆	cre
濽	crem
灒	cren
爨	crh
熶	crhm
穳	crhn
櫕	crim
欑	crin
镩	crj
鑹	crjm
鋑	crjn
篡	crk
簒	crkm
巑	crsm
菆	crum
窜	crx
竄	crxm
窽	crxn
窾	crxo
蹿	crz
躥	crzm
匆	csb
賩	csbm
賨	csbn
從	cscm
徔	cscn
従	csco
徖	cscp
蟌	cscq
淙	cse
潀	csem
潈	csen
漗	cseo
漎	csep
潨	cseq
灇	cser
聪	csf
聰	csfm
聡	csfn
聦	csfo
繱	csfp
丛	csh
焧	cshm
熜	cshn
爜	csho
枞	csi
樅	csim
棇	csin
楤	csio
樬	csip
樷	csiq
欉	csir
錝	csjm
鍯	csjn
鏓	csjo
鏦	csjp
篵	cskm
骢	csm
驄	csmm
瞛	csmn
騘	csmo
婃	csnm
囱	csp
碂	cspm
暰	csrm
葱	csu
苁	csub
蔥	csum
蓯	csun
茐	csuo
藂	csup
从	csv
琮	csw
璁	cswb
囪	cswm
瑽	cswn
忩	csxm
怱	csxn
悤	csxo
悰	csxp
愡	csxq
慒	csxr
憁	csxs
叢	csym
誴	csyn
謥	csyo
孮	cszm
瘄	cubm
瘯	cubn
徂	cuc
殂	cud
縬	cufm
橻	cuim
觕	cujm
簇	cuk
脨	culm
麁	culn
麄	culo
麆	culp
麤	culq
粗	cum
鼀	cumm
媨	cunm
噈	cuom
皻	cupm
醋	cuq
猝	cuqb
酢	cuqc
卒	cus
蔟	cuu
促	cuv
怚	cuxm
憱	cuxn
誎	cuym
顣	cuyn
蹙	cuz
蹴	cuzb
趨	cuzm
趗	cuzn
踀	cuzo
踧	cuzp
踿	cuzq
蹵	cuzr
摧	cva
瘁	cvb
疩	cvbm
凗	cvbn
皠	cvbo
淬	cve
漼	cvem
濢	cven
紣	cvfm
缞	cvfn
綷	cvfo
縗	cvfp
焠	cvhm
熣	cvhn
榱	cvi
椊	cvim
槯	cvin
鏙	cvjm
衰	cvk
襊	cvkm
脆	cvl
脃	cvlm
脺	cvln
膵	cvlo
膬	cvlp
臎	cvlq
粹	cvm
毳	cvmb
粋	cvmm
啐	cvo
啛	cvom
磪	cvpm
獕	cvqm
崔	cvs
崒	cvsm
嵟	cvsn
墔	cvtm
萃	cvu
催	cvv
伜	cvvm
倅	cvvn
璀	cvw
琗	cvwm
悴	cvx
忰	cvxm
慛	cvxn
竁	cvxo
翠	cvy
翆	cvym
顇	cvyn
趡	cvzm
橧	czim
竲	czlm
驓	czmm
噌	czo
层	czp
層	czpm
曾	czr
曽	czrm
嶒	czsm
蹭	czz
打	daa
搭	daab
撘	daam
瘩	dab
匒	dabm
蟽	dacm
大	dad
耷	dadb
剳	dadm
沓	dae
汏	daem
溚	daen
繨	dafm
鞑	dag
靼	dagb
韃	dagm
炟	dahm
燵	dahn
鎝	dajm
鎉	dajn
鐽	dajo
答	dak
褡	dakb
笪	dakc
笚	dakm
龖	dalm
龘	daln
眔	damm
妲	dan
嗒	dao
哒	daob
噠	daom
咑	daon
呾	daoo
亣	datm
垯	datn
畗	dato
畣	datp
墶	datq
荙	daum
荅	daun
薘	dauo
怛	dax
憚	daxm
羍	daym
詚	dayn
达	daz
達	dazm
迏	dazn
迖	dazo
迚	dazp
逹	dazq
跶	dazr
躂	dazs
捣	dca
搗	dcam
捯	dcan
擣	dcao
导	dcc
導	dccm
衜	dccn
螩	dcco
衟	dccp
到	dcd
刀	dcdb
刂	dcdc
纛	dcf
陦	dcfm
絩	dcfn
隝	dcfo
隯	dcfp
稻	dch
焘	dchb
燾	dchm
稲	dchn
朷	dcim
梼	dcin
椡	dcio
槝	dcip
檤	dciq
檮	dcir
帱	dcj
幬	dcjm
釖	dcjn
裯	dckm
箌	dckn
盗	dcm
盜	dcmm
叨	dco
嘄	dcom
噵	dcon
氘	dcq
岛	dcs
祷	dcsb
島	dcsm
禱	dcsn
屶	dcso
禂	dcsp
嶋	dcsq
嶌	dcsr
嶹	dcss
軇	dcst
壔	dctm
菿	dcum
倒	dcv
儔	dcvm
瓙	dcwm
悼	dcx
忉	dcxb
鱽	dcym
魛	dcyn
翢	dcyo
翿	dcyp
道	dcz
蹈	dczb
辺	dczm
舠	dczn
艔	dczo
贷	ddb
貸	ddbm
貣	ddbn
待	ddc
轪	ddcm
軑	ddcn
軚	ddco
蚮	ddcp
軩	ddcq
蝳	ddcr
歹	ddd
大	dddb
殆	dddc
歺	dddm
汏	ddem
瀻	dden
绐	ddf
紿	ddfm
緿	ddfn
戴	ddg
甙	ddgb
廗	ddgm
黛	ddh
黱	ddhm
柋	ddim
带	ddj
帶	ddjm
帒	ddjn
帯	ddjo
釱	ddjp
袋	ddk
箉	ddkm
簤	ddkn
襶	ddko
隸	ddlm
隷	ddln
駘	ddmm
鴏	ddnm
呆	ddo
呔	ddob
獃	ddqm
曃	ddrm
霴	ddrn
靆	ddro
岱	dds
叇	ddsm
埭	ddt
垈	ddtm
代	ddv
傣	ddvb
侢	ddvm
玳	ddw
瑇	ddwm
怠	ddx
懛	ddxm
詒	ddym
逮	ddz
迨	ddzb
跢	ddzm
艜	ddzn
蹛	ddzo
的	deb
得	dec
德	decb
蚮	decm
徳	decn
淂	deem
底	deg
棏	deim
锝	dej
鍀	dejm
脦	delm
嘚	deom
旳	derm
地	det
恴	dexm
惪	dexn
悳	dexo
抖	dfa
痘	dfb
蚪	dfc
斗	dfd
豆	dfdb
鬥	dfdm
剅	dfdn
鬦	dfdo
斣	dfdp
鬪	dfdq
鬭	dfdr
鬬	dfds
兜	dfe
瀆	dfem
浢	dfen
兠	dfeo
都	dff
陡	dffb
阧	dffm
郖	dffn
枓	dfim
梪	dfin
橷	dfio
钭	dfj
鈄	dfjm
鋀	dfjn
篼	dfk
脰	dflm
毭	dfmm
閗	dfmn
瞗	dfmo
闘	dfmp
吋	dfom
吺	dfon
唗	dfoo
唞	dfop
狵	dfqm
酘	dfqn
饾	dfsm
餖	dfsn
畓	dftm
蔸	dfu
荳	dfum
乧	dfvm
侸	dfvn
窦	dfx
竇	dfxm
读	dfy
讀	dfym
逗	dfz
扥	dgam
扽	dgan
挡	dha
擋	dham
攩	dhan
宕	dhb
蟷	dhcm
党	dhe
氹	dhem
潒	dhen
澢	dheo
灙	dhep
黨	dhhm
档	dhi
檔	dhim
欓	dhin
铛	dhj
鐺	dhjm
裆	dhk
凼	dhkb
襠	dhkm
筜	dhkn
簜	dhko
簹	dhkp
瞊	dhmm
盪	dhmn
闣	dhmo
婸	dhnm
噹	dhom
砀	dhp
碭	dhpm
礑	dhpn
雼	dhrm
崵	dhsm
嵣	dhsn
場	dhtm
當	dhtn
圵	dhto
垱	dhtp
壋	dhtq
荡	dhu
菪	dhub
蕩	dhum
蘯	dhun
偒	dhvm
儅	dhvn
珰	dhwm
瓽	dhwn
璫	dhwo
璗	dhwp
当	dhx
愓	dhxm
谠	dhy
讜	dhym
譡	dhyn
逿	dhzm
趤	dhzn
艡	dhzo
抵	dia
提	diab
扚	diam
拞	dian
掋	diao
揥	diap
摕	diaq
弟	dib
的	dibb
髢	dibm
厎	dicm
彽	dicn
蚳	dico
軧	dicp
蝃	dicq
蝭	dicr
螮	dics
奀	didm
奃	didn
滴	die
涤	dieb
滌	diem
浟	dien
渧	dieo
缔	dif
邸	difb
締	difm
阺	difn
隄	difo
聜	difp
底	dig
骶	digb
弤	digm
靮	dign
鞮	digo
秪	dihm
焍	dihn
棣	dii
柢	diib
杕	diim
枤	diin
枑	diio
梊	diip
梑	diiq
楴	diir
樀	diis
帝	dij
镝	dijb
觌	dijc
鏑	dijm
覿	dijn
釱	dijo
觝	dijp
鉪	dijq
第	dik
笛	dikb
袛	dikm
篴	dikn
肑	dilm
腣	diln
睇	dim
籴	dimb
糴	dimm
眱	dimn
馰	dimo
嫡	din
娣	dinb
牴	dinm
媂	dinn
鸐	dino
嘀	dio
呧	diom
哋	dion
唙	dioo
啲	diop
啇	dioq
嚁	dior
砥	dip
碲	dipb
碮	dipm
磾	dipn
狄	diq
旳	dirm
氐	dis
祗	disb
岻	dism
祶	disn
禘	diso
嵽	disp
嶳	disq
豴	disr
地	dit
堤	ditb
坻	ditc
墑	ditm
坘	ditn
坔	dito
埅	ditp
埊	ditq
埞	ditr
墆	dits
墬	ditt
蒂	diu
荻	diub
蓧	dium
苖	diun
苐	diuo
菂	diup
菧	diuq
蔕	diur
蔐	dius
蔋	diut
藡	diuu
低	div
仾	divm
俤	divn
偙	divo
僀	divp
敌	diw
敵	diwm
玓	diwn
珶	diwo
甋	diwp
怟	dixm
慸	dixn
诋	diy
翟	diyb
谛	diyc
羝	diyd
詆	diym
諦	diyn
廸	diyo
頔	diyp
諟	diyq
鯳	diyr
迪	diz
递	dizb
遞	dizm
逓	dizn
趆	dizo
遆	dizp
疐	dizq
遰	dizr
踶	dizs
蹢	dizt
掂	dja
攧	djam
典	djb
癫	djbb
癜	djbc
癲	djbm
痁	djbn
痶	djbo
瘨	djbp
厧	djcm
蜔	djcn
齻	djco
奠	djd
丶	djdb
奌	djdm
淀	dje
滇	djeb
澱	djem
阽	djf
店	djg
点	djh
點	djhm
扂	djhn
椣	djim
槙	djin
槇	djio
橝	djip
橂	djiq
钿	djj
鈿	djjm
簟	djk
驔	djmm
婰	djnm
婝	djnn
嚸	djom
殿	djp
碘	djpb
磹	djpm
靛	djq
猠	djqm
電	djrm
巅	djs
巔	djsm
嵮	djsn
巓	djso
电	djt
垫	djtb
甸	djtc
坫	djtd
墊	djtm
壂	djtn
蒧	djum
蕇	djun
佃	djv
佔	djvm
傎	djvn
玷	djw
敁	djwm
琔	djwn
敟	djwo
惦	djx
窴	djxm
颠	djy
顛	djym
顚	djyn
踮	djz
跕	djzm
蹎	djzn
撴	dkam
撉	dkan
蜳	dkcm
沌	dke
潡	dkem
庉	dkgm
炖	dkh
不	dkhb
燉	dkhm
楯	dkim
橔	dkin
钝	dkj
镦	dkjb
鈍	dkjm
鐓	dkjn
盾	dkm
盹	dkmb
驐	dkmm
犜	dknm
吨	dko
噸	dkom
礅	dkp
砘	dkpb
碷	dkpm
獤	dkqm
壿	dksm
墩	dkt
坉	dktm
墫	dktn
墪	dkto
伅	dkvm
敦	dkw
囤	dkwb
忳	dkxm
惇	dkxn
憞	dkxo
顿	dky
頓	dkym
蹲	dkz
遁	dkzb
趸	dkzc
躉	dkzm
逇	dkzn
遯	dkzo
踲	dkzp
蹾	dkzq
担	dla
掸	dlab
撣	dlam
擔	dlan
抌	dlao
撢	dlap
单	dlb
疸	dlbb
瘅	dlbc
赕	dlbd
賧	dlbm
癉	dlbn
髧	dlbo
癚	dlbp
贉	dlbq
蛋	dlc
蜑	dlcm
殚	dld
殫	dldm
刐	dldn
淡	dle
澹	dleb
泹	dlem
沊	dlen
澸	dleo
耽	dlf
郸	dlfb
聃	dlfc
鄲	dlfm
耼	dlfn
紞	dlfo
匰	dlfp
聸	dlfq
繵	dlfr
弹	dlg
彈	dlgm
弾	dlgn
黕	dlhm
燀	dlhn
黮	dlho
黵	dlhp
柦	dlim
卩	dlj
帎	dljm
觛	dljn
凼	dlk
箪	dlkb
簞	dlkm
衴	dlkn
褝	dlko
襌	dlkp
胆	dll
膽	dllm
腅	dlln
勯	dllo
眈	dlm
馾	dlmm
駳	dlmn
妉	dlnm
媅	dlnn
鴠	dlno
啖	dlo
單	dlom
呾	dlon
唌	dloo
啗	dlop
啿	dloq
噉	dlor
嘾	dlos
嚪	dlot
石	dlp
丹	dlpb
砃	dlpm
皽	dlpn
氮	dlq
狚	dlqm
酖	dlqn
醈	dlqo
旦	dlr
霮	dlrm
単	dlsm
躭	dlsn
餤	dlso
禫	dlsp
饏	dlsq
亶	dltm
萏	dlu
菪	dlub
蓞	dlum
但	dlv
儋	dlvb
亻	dlvc
伔	dlvm
僤	dlvn
玬	dlwm
瓭	dlwn
甔	dlwo
惮	dlx
憚	dlxm
惔	dlxn
愖	dlxo
窞	dlxp
憺	dlxq
诞	dly
誕	dlym
訑	dlyn
頕	dlyo
譂	dlyp
疍	dlzm
掉	dma
扚	dmam
凋	dmb
瘹	dmbm
虭	dmcm
蛁	dmcn
刁	dmd
刟	dmdm
奝	dmdn
殦	dmdo
汈	dmem
絩	dmfm
弔	dmgm
弴	dmgn
椆	dmim
钓	dmj
铞	dmjb
铫	dmjc
釣	dmjm
銱	dmjn
銚	dmjo
鈟	dmjp
鋽	dmjq
錭	dmjr
鑃	dmjs
簓	dmkm
竨	dmlm
盄	dmmm
瞗	dmmn
鸟	dmn
鳥	dmnm
鳭	dmnn
鵰	dmno
吊	dmo
叼	dmob
碉	dmp
屌	dmpm
雿	dmrm
彫	dmsm
鼦	dmsn
蓧	dmum
藋	dmun
伄	dmvm
琱	dmwm
窎	dmxm
窵	dmxn
调	dmy
鲷	dmyb
調	dmym
鯛	dmyn
訋	dmyo
誂	dmyp
魡	dmyq
鮉	dmyr
雕	dmz
貂	dmzb
颩	dnfm
丟	dnhm
铥	dnj
銩	dnjm
丢	dnp
掇	doa
挆	doam
挅	doan
痑	dobm
痥	dobn
凙	dobo
鬌	dobp
夺	dod
剁	dodb
奪	dodm
刴	dodn
剟	dodo
剫	dodp
奲	dodq
沲	doe
澤	doem
沰	doen
缍	dof
綞	dofm
陏	dofn
陊	dofo
隓	dofp
度	dog
朵	doi
柁	doib
朶	doim
杕	doin
杝	doio
枤	doip
柂	doiq
柮	doir
桗	dois
椯	doit
铎	doj
鐸	dojm
鈬	dojn
錞	dojo
裰	dok
袳	dokm
驮	dom
馱	domm
毲	domn
駄	domo
媠	donm
鵽	donn
哆	doo
咄	doob
哚	dooc
喥	doom
嚉	doon
嚲	dooo
硾	dopm
躲	dos
饳	dosm
崜	dosn
躱	doso
飿	dosp
嶞	dosq
軃	dosr
堕	dot
垛	dotb
墮	dotm
垜	dotn
埵	doto
墯	dotp
亸	dotq
仛	dovm
敓	dowm
敚	down
敠	dowo
敪	dowp
多	dox
惰	doxb
夛	doxm
憜	doxn
尮	doym
鮵	doyn
跺	doz
舵	dozb
踱	dozc
趓	dozm
跢	dozn
跥	dozo
得	dpc
嘚	dpom
剬	drdm
耑	drem
缎	drf
緞	drfm
煅	drh
椴	dri
断	drj
锻	drjb
鍛	drjm
斷	drjn
鍴	drjo
簖	drk
籪	drkm
褍	drkn
端	drl
腶	drlm
媏	drnm
段	drp
碫	drpm
毈	drpn
短	drs
塅	drtm
葮	drum
偳	drvm
瑖	drwm
躖	drzm
挏	dsam
揰	dsan
冻	dsb
凍	dsbm
蝀	dscm
洞	dse
涷	dsem
湩	dsen
絧	dsfm
戙	dsgm
鼕	dsgn
东	dsh
烔	dshm
燑	dshn
栋	dsi
東	dsim
棟	dsin
笗	dskm
箽	dskn
动	dsl
胴	dslb
胨	dslc
動	dslm
腖	dsln
勭	dslo
駧	dsmm
鸫	dsn
鶇	dsnm
姛	dsnn
娻	dsno
嬞	dsnp
鶫	dsnq
咚	dso
硐	dsp
氡	dsq
狪	dsqm
氭	dsqn
昸	dsrm
霘	dsrn
峒	dss
岽	dssb
崠	dssm
崬	dssn
垌	dst
埬	dstm
墥	dstn
董	dsu
苳	dsum
菄	dsun
蕫	dsuo
侗	dsv
倲	dsvm
働	dsvn
懂	dsx
恫	dsxb
諌	dsym
鮗	dsyn
鯟	dsyo
冬	dsz
夂	dszb
迵	dszm
揲	dta
挕	dtam
蝶	dtc
軼	dtcm
镻	dtcn
蜨	dtco
螲	dtcp
殜	dtdm
泆	dtem
爹	dtf
绖	dtfm
絰	dtfn
瓞	dtg
戜	dtgm
鞢	dtgn
柣	dtim
楪	dtin
槢	dtio
幉	dtjm
褋	dtkm
褺	dtkn
耋	dtl
胅	dtlm
耊	dtln
眣	dtmm
眰	dtmn
氎	dtmo
鴩	dtnm
喋	dto
哋	dtom
咥	dton
啑	dtoo
碟	dtp
牒	dtpb
牃	dtpm
昳	dtrm
曡	dtrn
峌	dtsm
崼	dtsn
嵽	dtso
堞	dtt
垤	dttb
疊	dttm
畳	dttn
疂	dtto
疉	dttp
苵	dtum
怢	dtxm
恎	dtxn
惵	dtxo
叠	dty
谍	dtyb
鲽	dtyc
諜	dtym
鰈	dtyn
詄	dtyo
跌	dtz
迭	dtzb
蹀	dtzc
臷	dtzm
趃	dtzn
跕	dtzo
跮	dtzp
艓	dtzq
蹛	dtzr
赌	dub
賭	dubm
凟	dubn
贕	dubo
蠹	duc
蝳	ducm
螙	ducn
蠧	duco
剢	dudm
殬	dudn
殰	dudo
渡	due
渎	dueb
瀆	duem
涜	duen
都	duf
匵	dufm
度	dug
髑	dugb
靯	dugm
豄	dugn
韇	dugo
黩	duh
黷	duhm
秺	duhn
杜	dui
椟	duib
櫝	duim
镀	duj
鍍	dujm
帾	dujn
覩	dujo
錖	dujp
鑟	dujq
笃	duk
篤	dukm
裻	dukn
肚	dul
毒	dum
督	dumb
睹	dumc
阇	dumm
闍	dumn
騳	dumo
妒	dun
犊	dunb
犢	dunm
妬	dunn
姤	duno
嬻	dunp
嘟	duo
叾	duom
牍	dup
牘	dupm
皾	dupn
独	duq
獨	duqm
醏	duqn
暏	durm
晵	durn
厾	dusm
堵	dut
芏	duu
荰	duum
琽	duwm
斁	duwn
瓄	duwo
韣	duwp
韥	duwq
读	duy
顿	duyb
讀	duym
頓	duyn
読	duyp
讟	duyq
搥	dvam
兑	dvb
兌	dvbm
痽	dvbn
对	dvc
對	dvcm
対	dvcn
轛	dvco
兊	dvem
濧	dven
濻	dveo
瀢	dvep
瀩	dveq
队	dvf
隊	dvfm
陮	dvfn
綐	dvfo
杸	dvim
镦	dvj
鐓	dvjm
錞	dvjn
鐜	dvjo
鴭	dvnm
啍	dvom
碓	dvp
磓	dvpm
祋	dvsm
堆	dvt
垖	dvtm
塠	dvtn
薱	dvum
敦	dvw
敓	dvwm
敚	dvwn
怼	dvx
憝	dvxb
懟	dvxm
憞	dvxn
頧	dvym
譈	dvyn
譵	dvyo
嗲	dwo
掟	dyam
定	dyb
疔	dybb
虰	dycm
鼎	dyd
鼑	dydm
濎	dyem
耵	dyf
聢	dyfm
靪	dygm
丁	dyh
椗	dyim
钉	dyj
锭	dyjb
釘	dyjm
錠	dyjn
鋌	dyjo
帄	dyjp
鐤	dyjq
腚	dyl
盯	dym
奵	dynm
叮	dyo
啶	dyob
碇	dyp
矴	dypm
碠	dypn
磸	dypo
酊	dyq
饤	dysm
飣	dysn
嵿	dyso
町	dyt
甼	dytm
艼	dyum
萣	dyun
薡	dyuo
仃	dyv
玎	dyw
忊	dyxm
顶	dyy
订	dyyb
訂	dyym
頂	dyyn
顁	dyyo
登	dzb
豋	dzdm
澄	dze
澂	dzem
瀓	dzen
邓	dzf
鄧	dzfm
隥	dzfn
戥	dzg
灯	dzh
燈	dzhm
櫈	dzim
凳	dzj
镫	dzjb
鐙	dzjm
覴	dzjn
等	dzk
簦	dzkb
竳	dzlm
瞪	dzm
嬁	dznm
噔	dzo
磴	dzp
嶝	dzs
墱	dztm
僜	dzvm
璒	dzwm
憕	dzxm
蹬	dzz
艠	dzzm
扼	eea
搕	eeam
搹	eean
搤	eeao
擜	eeap
匎	eebm
皒	eebn
痾	eebo
痷	eebp
齃	eebq
厄	eec
蛾	eecb
轭	eecc
軛	eecm
蚅	eecn
軶	eeco
蝁	eecp
齶	eecq
洝	eeem
涐	eeen
湂	eeeo
阿	eef
鄂	eefb
阨	eefm
阸	eefn
廅	eegm
戹	eehm
枙	eeim
櫮	eein
锷	eej
锇	eejb
鋨	eejm
鍔	eejn
卾	eejo
鈪	eejp
鈋	eejq
覨	eejr
鑩	eejs
腭	eel
丨	eelb
閼	eemm
睋	eemn
騀	eemo
鹅	een
娥	eenb
婀	eenc
鹗	eend
鵝	eenm
鶚	eenn
妸	eeno
妿	eenp
姶	eenq
娿	eenr
娾	eens
鵈	eent
鵞	eenu
哦	eeo
呃	eeob
噩	eeoc
吪	eeom
呝	eeon
咢	eeoo
咹	eeop
噁	eeoq
屙	eep
砐	eepm
砈	eepn
砵	eepo
砨	eepp
硆	eepq
磀	eepr
礘	eeps
欸	eeqm
歞	eeqn
饿	ees
峨	eesb
餓	eesm
岋	eesn
峉	eeso
峩	eesp
豟	eesq
崿	eesr
餩	eess
垩	eet
堊	eetm
堨	eetn
堮	eeto
萼	eeu
莪	eeub
苊	eeuc
蕚	eeum
俄	eev
偔	eevm
僫	eevn
囮	eewm
敋	eewn
珴	eewo
琧	eewp
恶	eex
愕	eexb
惡	eexm
悪	eexn
额	eey
鳄	eeyb
诶	eeyc
颚	eeyd
讹	eeye
谔	eeyf
訛	eeym
額	eeyn
諤	eeyo
顎	eeyp
鱷	eeyq
頋	eeyr
誐	eeys
魤	eeyt
頟	eeyu
頞	eeyv
譌	eeyw
鰐	eeyx
鰪	eeyy
讍	eeyz
遏	eez
迗	eezm
遌	eezn
遻	eezo
鞥	eggm
欸	eiqm
诶	eiy
誒	eiym
摁	ena
奀	endm
煾	enhm
嗯	eno
唔	enob
峎	ensm
蒽	enu
恩	enx
贰	erb
貳	erbm
貮	erbn
髶	erbo
髵	erbp
輀	ercm
轜	ercn
刵	erdm
二	ere
儿	ereb
而	erec
洱	ered
兒	erem
児	eren
耏	ereo
洏	erep
耳	erf
陑	erfm
聏	erfn
隭	erfo
杒	erim
栮	erin
栭	erio
梕	erip
樲	eriq
铒	erj
鉺	erjm
袻	erkm
胹	erlm
臑	erln
毦	ermm
粫	ermn
駬	ermo
鸸	ern
鴯	ernm
咡	erom
唲	eron
饵	ers
餌	ersm
峏	ersn
荋	erum
薾	erun
佴	erv
侕	ervm
乻	ervn
珥	erw
尔	erx
爾	erxm
尓	erxn
尒	erxo
衈	erxp
鲕	ery
鮞	erym
弍	eryn
弐	eryo
誀	eryp
迩	erz
邇	erzm
趰	erzn
發	fabm
冹	fabn
疺	fabo
発	fabp
髪	fabq
髮	fabr
法	fae
沷	faem
浌	faen
灋	faeo
彂	fagm
栰	faim
橃	fain
鍅	fajm
筏	fak
笩	fakm
阀	fam
閥	famm
瞂	famn
姂	fanm
乏	fap
砝	fapb
酦	faqm
醗	faqn
醱	faqo
罚	fas
罰	fasm
峜	fasn
罸	faso
垡	fat
坺	fatm
墢	fatn
茷	faum
蕟	faun
藅	fauo
伐	fav
佱	favm
傠	favn
珐	faw
琺	fawm
发	fay
殕	ffdm
缶	fff
缻	fffm
缹	fffn
紑	fffo
炰	ffhm
妚	ffnm
鴀	ffnn
否	ffo
雬	ffrm
蚡	fgcm
蚠	fgcn
轒	fgco
分	fgd
奋	fgdb
奮	fgdm
汾	fge
瀵	fgeb
濆	fgem
纷	fgf
紛	fgfm
隫	fgfn
弅	fggm
鼖	fggn
焚	fgh
炃	fghm
秎	fghn
燓	fgho
燌	fghp
棼	fgi
枌	fgim
棻	fgin
梤	fgio
橨	fgip
帉	fgjm
鈖	fgjn
幩	fgjo
鐼	fgjp
衯	fgkm
朌	fglm
竕	fgln
膹	fglo
粉	fgm
粪	fgmb
糞	fgmm
瞓	fgmn
黂	fgmo
妢	fgnm
鳻	fgnn
吩	fgo
哛	fgom
砏	fgpm
氛	fgq
酚	fgqb
獖	fgqm
昐	fgrm
雰	fgrn
朆	fgro
鼢	fgs
岎	fgsm
躮	fgsn
豮	fgso
餴	fgsp
豶	fgsq
饙	fgsr
坟	fgt
墳	fgtm
坆	fgtn
坋	fgto
芬	fgu
蒶	fgum
蕡	fgun
份	fgv
偾	fgvb
僨	fgvm
玢	fgw
瓰	fgwm
愤	fgx
忿	fgxb
憤	fgxm
馚	fgxn
馩	fgxo
鲼	fgy
鱝	fgym
羒	fgyn
翂	fgyo
訜	fgyp
魵	fgyq
黺	fgyr
羵	fgys
髣	fhbm
彷	fhc
蚄	fhcm
汸	fhem
淓	fhen
方	fhf
防	fhfb
纺	fhfc
邡	fhfd
匚	fhfe
紡	fhfm
旊	fhfn
房	fhh
枋	fhi
钫	fhj
鈁	fhjm
錺	fhjn
肪	fhl
眆	fhmm
眪	fhmn
妨	fhn
牥	fhnm
鴋	fhnn
鶭	fhno
昉	fhrm
昘	fhrn
昞	fhro
祊	fhsm
坊	fht
埅	fhtm
堏	fhtn
芳	fhu
仿	fhv
倣	fhvm
放	fhw
瓬	fhwm
访	fhy
鲂	fhyb
訪	fhym
魴	fhyn
舫	fhz
趽	fhzm
払	flam
贩	flb
販	flbm
軓	flcm
軬	flcn
輽	flco
轓	flcp
蠜	flcq
樊	fld
泛	fle
氾	flem
汎	flen
滼	fleo
瀪	flep
瀿	fleq
繁	flf
匥	flfm
緐	flfn
旙	flfo
旛	flfp
繙	flfq
颿	flfr
飜	flfs
烦	flh
燔	flhb
煩	flhm
梵	fli
杋	flim
柉	flin
桳	flio
棥	flip
橎	fliq
凡	flj
帆	fljb
幡	fljc
钒	fljd
釩	fljm
凣	fljn
凢	fljo
鐇	fljp
範	flkm
笵	flkn
笲	flko
襎	flkp
籓	flkq
勫	fllm
膰	flln
籵	flmm
盕	flmn
奿	flnm
婏	flnn
嬏	flno
嬎	flnp
鷭	flnq
噃	flom
矾	flp
礬	flpm
犯	flq
犭	flqb
犿	flqm
饭	fls
飯	flsm
飰	flsn
番	flt
畈	fltb
畨	fltm
墦	fltn
范	flu
藩	flub
蕃	fluc
蘩	flud
薠	flum
仮	flvm
攵	flw
璠	flwm
忛	flxm
憣	flxn
反	fly
翻	flyb
訉	flym
羳	flyn
鱕	flyo
返	flz
夂	flzb
蹯	flzc
辺	flzm
舤	flzn
舧	flzo
舩	flzp
覅	fmxm
梻	foim
坲	fotm
佛	fov
仏	fovm
仸	fovn
费	fpb
痱	fpbb
費	fpbm
發	fpbn
疿	fpbo
癈	fpbp
蜚	fpc
厞	fpcm
蜰	fpcn
蟦	fpco
剕	fpdm
奜	fpdn
沸	fpe
淝	fpeb
渄	fpem
濷	fpen
飞	fpf
非	fpfb
匪	fpfc
绯	fpfd
飛	fpfm
緋	fpfn
陫	fpfo
靟	fpfp
飝	fpfq
废	fpg
廢	fpgm
廃	fpgn
扉	fph
榧	fpi
杮	fpim
柹	fpin
棐	fpio
橨	fpip
橃	fpiq
櫠	fpir
镄	fpj
鐨	fpjm
篚	fpk
笰	fpkm
裶	fpkn
襏	fpko
肥	fpl
肺	fplb
腓	fplc
胏	fplm
胇	fpln
朏	fplo
胐	fplp
騑	fpmm
騛	fpmn
妃	fpn
婓	fpnm
婔	fpnn
啡	fpo
吠	fpob
砩	fpp
屝	fppm
狒	fpq
犻	fpqm
猆	fpqn
霏	fpr
昲	fprm
暃	fprn
曊	fpro
靅	fprp
餥	fpsm
鼣	fpsn
菲	fpu
芾	fpub
萉	fpum
蕜	fpun
俷	fpvm
斐	fpw
悱	fpx
怫	fpxb
馡	fpxm
翡	fpy
诽	fpyb
鲱	fpyc
誹	fpym
鯡	fpyn
扶	fua
抚	fuab
拂	fuac
拊	fuad
撫	fuam
払	fuan
抙	fuao
捊	fuap
捬	fuaq
富	fub
负	fubb
赋	fubc
匐	fubd
赙	fube
負	fubm
賦	fubn
賻	fubo
冹	fubp
髴	fubq
癁	fubr
辅	fuc
蝠	fucb
辐	fucc
蝮	fucd
蚨	fuce
蜉	fucf
復	fucm
輔	fucn
輻	fuco
彿	fucp
尃	fucq
蚥	fucr
蚹	fucs
蛗	fuct
蜅	fucu
蝜	fucv
輹	fucw
夫	fud
副	fudb
刜	fudm
浮	fue
涪	fueb
滏	fuec
泭	fuem
洑	fuen
澓	fueo
父	fuf
附	fufb
缚	fufc
釜	fufd
阜	fufe
绂	fuff
绋	fufg
阝	fufh
郛	fufi
縛	fufm
紱	fufn
紼	fufo
邞	fufp
郙	fufq
旉	fufr
紨	fufs
絥	fuft
颫	fufu
鄜	fufv
綍	fufw
綒	fufx
颰	fufy
緮	fufz
府	fug
弗	fugb
弣	fugm
鬴	fugn
稃	fuh
炥	fuhm
虙	fuhn
烰	fuho
秿	fuhp
焤	fuhq
稪	fuhr
桴	fui
枎	fuim
柭	fuin
柎	fuio
枹	fuip
柫	fuiq
栿	fuir
棴	fuis
椨	fuit
椱	fuiu
榑	fuiv
幅	fuj
斧	fujb
凫	fujc
幞	fujd
巿	fujm
帗	fujn
釡	fujo
鈇	fujp
鉜	fujq
鉘	fujr
鍢	fujs
鍑	fujt
符	fuk
袱	fukb
襆	fukm
衭	fukn
袚	fuko
袝	fukp
笰	fukq
筟	fukr
箙	fuks
箁	fukt
褔	fuku
複	fukv
簠	fukw
襥	fukx
服	ful
腹	fulb
肤	fulc
脯	fuld
腑	fule
膚	fulm
竎	fuln
胕	fulo
驸	fum
麸	fumb
駙	fumm
麩	fumn
冨	fumo
盙	fump
粰	fumq
麬	fumr
糐	fums
麱	fumt
妇	fun
婦	funm
鳧	funn
乀	funo
妋	funp
姇	funq
鳬	funr
娐	funs
婏	funt
媍	funu
鳺	funv
鴔	funw
嬔	funx
鵩	funy
鶝	funz
咐	fuo
呒	fuob
呋	fuoc
嘸	fuom
咈	fuon
哹	fuoo
喸	fuop
砩	fup
砆	fupm
氟	fuq
酜	fuqm
腐	fur
福	fus
罘	fusb
祓	fusc
艴	fusd
岪	fusm
峊	fusn
祔	fuso
罦	fusp
豧	fusq
禣	fusr
甶	futm
坿	futn
垘	futo
畐	futp
畉	futq
垺	futr
畗	futs
芙	fuu
莆	fuub
茯	fuuc
苻	fuud
菔	fuue
芾	fuuf
莩	fuug
芣	fuum
茀	fuun
荂	fuuo
荴	fuup
萉	fuuq
葍	fuur
萯	fuus
蓲	fuut
蕧	fuuu
付	fuv
伏	fuvb
傅	fuvc
佛	fuvd
俘	fuve
俯	fuvf
乥	fuvm
伕	fuvn
乶	fuvo
俌	fuvp
俛	fuvq
偪	fuvr
偩	fuvs
敷	fuw
玞	fuwm
玸	fuwn
韨	fuwo
琈	fuwp
韍	fuwq
璷	fuwr
覆	fux
馥	fuxb
怫	fuxc
怤	fuxm
覄	fuxn
懯	fuxo
甫	fuy
讣	fuyb
黻	fuyc
鲋	fuyd
黼	fuye
鳆	fuyf
訃	fuym
鮒	fuyn
鰒	fuyo
翇	fuyp
詂	fuyq
頫	fuyr
鮄	fuys
諨	fuyt
鮲	fuyu
复	fuz
赴	fuzb
孵	fuzc
孚	fuzd
趺	fuze
跗	fuzf
艀	fuzm
踾	fuzn
捀	fzam
摓	fzan
疯	fzb
冯	fzbb
瘋	fzbm
赗	fzbn
賵	fzbo
寷	fzbp
封	fzc
蜂	fzcb
蠭	fzcm
奉	fzd
豐	fzdm
沣	fze
灃	fzem
沨	fzen
浲	fzeo
湗	fzep
溄	fzeq
渢	fzer
漨	fzes
风	fzf
缝	fzfb
酆	fzfc
風	fzfm
縫	fzfn
綘	fzfo
鄷	fzfp
飌	fzfq
纀	fzfz
烽	fzh
炐	fzhm
焨	fzhn
煈	fzho
熢	fzhp
枫	fzi
楓	fzim
桻	fzin
檒	fzio
锋	fzj
凤	fzjb
鋒	fzjm
凨	fzjn
凬	fzjo
凮	fzjp
鎽	fzjq
鏠	fzjr
篈	fzkm
丰	fzl
馮	fzmm
盽	fzmn
麷	fzmo
鳳	fznm
妦	fznn
犎	fzno
鳯	fznp
鴌	fznq
唪	fzo
砜	fzp
碸	fzpm
猦	fzqm
靊	fzrm
峰	fzs
峯	fzsm
崶	fzsn
埄	fztm
堼	fztn
堸	fzto
葑	fzu
莑	fzum
蘴	fzun
俸	fzv
仹	fzvm
偑	fzvn
僼	fzvo
琒	fzwm
覂	fzxm
讽	fzy
諷	fzym
甮	fzyn
逢	fzz
夆	fzzm
艂	fzzn
轧	gac
軋	gacm
夹	gad
夾	gadm
魀	gagm
钆	gaj
釓	gajm
錷	gajn
朒	galm
嘎	gao
咖	gaob
噶	gaoc
嘠	gaom
玍	gapm
旮	gar
垓	gat
伽	gav
尜	gax
尕	gaxb
尬	gay
搞	gca
皋	gcb
皐	gcbm
夰	gcdm
郜	gcf
缟	gcfb
縞	gcfm
高	gcg
髙	gcgm
鼛	gcgn
稿	gch
稁	gchm
稾	gchn
槁	gci
杲	gcib
槔	gcic
橰	gcim
槀	gcin
槹	gcio
檺	gcip
櫜	gciq
镐	gcj
锆	gcjb
鎬	gcjm
鋯	gcjn
篙	gck
筶	gckm
膏	gcl
勂	gclm
糕	gcm
睪	gcmm
鷎	gcnm
鷱	gcnn
告	gco
吿	gcom
睾	gcp
獋	gcqm
暠	gcrm
峼	gcsm
祮	gcsn
祰	gcso
禞	gcsp
餻	gcsq
藁	gcu
菒	gcum
藳	gcun
韟	gcwm
羔	gcy
诰	gcyb
誥	gcym
羙	gcyn
臯	gczm
摡	gdam
赅	gdb
賅	gdbm
匃	gdbn
匄	gdbo
賌	gdbp
溉	gde
漑	gdem
陔	gdf
郂	gdfm
隑	gdfn
絠	gdfo
絯	gdfp
戤	gdg
丐	gdh
概	gdi
杚	gdim
槩	gdin
槪	gdio
钙	gdj
鈣	gdjm
盖	gdm
姟	gdnm
硙	gdpm
磑	gdpn
晐	gdrm
峐	gdsm
祴	gdsn
豥	gdso
垓	gdt
畡	gdtm
芥	gdu
蓋	gdum
荄	gdun
葢	gduo
乢	gdvm
侅	gdvn
改	gdw
瓂	gdwm
忋	gdxm
该	gdy
該	gdym
搁	gea
搿	geab
擱	geam
扢	gean
挌	geao
疙	geb
匌	gebm
蛤	gec
虼	gecb
蛒	gecm
輵	gecn
轕	geco
割	ged
滒	geem
滆	geen
隔	gef
纥	gefb
紇	gefm
革	geg
戈	gegb
骼	gegc
鬲	gegd
戓	gegm
彁	gegn
戨	gego
鞈	gegp
鞷	gegq
格	gei
杚	geim
槅	gein
櫊	geio
铬	gej
镉	gejb
鉻	gejm
鎘	gejn
觡	gejo
鎑	gejp
鎶	gejq
袼	gek
笴	gekm
裓	gekn
箇	geko
胳	gel
膈	gelb
肐	gelm
臈	geln
阁	gem
盖	gemb
閣	gemm
閤	gemn
騔	gemo
鸽	gen
鴿	genm
牫	genn
鴚	geno
鴐	genp
哥	geo
合	geob
各	geoc
咯	geod
嗝	geoe
哿	geof
吤	geom
呄	geon
嘅	geoo
嗰	geop
硌	gep
歌	geq
犵	geqm
猲	geqn
獦	geqo
饹	gesm
餎	gesn
圪	get
塥	getb
葛	geu
蓋	geum
茖	geun
虄	geuo
个	gev
仡	gevb
個	gevm
佮	gevn
佫	gevo
敋	gewm
韐	gewn
韚	gewo
愅	gexm
颌	gey
頜	geym
鲄	geyn
魺	geyo
諽	geyp
鮯	geyq
鮥	geyr
謌	geys
舸	gez
臵	gezm
搆	gfam
撀	gfan
购	gfb
勾	gfbb
購	gfbm
痀	gfbn
蚼	gfcm
沟	gfe
溝	gfem
缑	gff
緱	gffm
鞲	gfg
煹	gfhm
构	gfi
枸	gfib
構	gfim
钩	gfj
觏	gfjb
鉤	gfjm
覯	gfjn
鈎	gfjo
篝	gfk
笱	gfkb
袧	gfkm
褠	gfkn
簼	gfko
耇	gflm
耉	gfln
耈	gflo
糓	gfmm
媾	gfn
姤	gfnm
句	gfo
呴	gfom
啂	gfon
彀	gfp
狗	gfq
岣	gfs
垢	gft
坸	gftm
冓	gftn
苟	gfu
芶	gfum
佝	gfv
傋	gfvm
韝	gfwm
玽	gfwn
够	gfx
夠	gfxm
诟	gfy
詬	gfym
訽	gfyn
遘	gfz
豿	gfzm
雊	gfzn
搄	ggam
揯	ggan
亙	ggem
艮	ggg
亘	ggh
根	ggi
哏	ggo
茛	ggu
跟	ggz
扛	gha
掆	gham
摃	ghan
冮	ghbm
疘	ghbn
刚	ghd
剛	ghdm
港	ghe
纲	ghf
缸	ghfb
綱	ghfm
罁	ghfn
焵	ghhm
焹	ghhn
杠	ghi
棡	ghim
槓	ghin
钢	ghj
鋼	ghjm
釭	ghjn
鎠	ghjo
筻	ghk
肛	ghl
牨	ghnm
犅	ghnn
矼	ghpm
碙	ghpn
犺	ghqm
岗	ghs
罡	ghsb
岡	ghsm
崗	ghsn
冈	ght
堈	ghtm
堽	ghtn
戆	ghx
戇	ghxm
戅	ghxn
怾	gixm
辊	gkc
輥	gkcm
滚	gke
滾	gkem
绲	gkf
緄	gkfm
緷	gkfn
棍	gki
棞	gkim
袞	gkkm
裷	gkkn
丨	gkl
睔	gkmm
磙	gkp
硍	gkpm
衮	gkt
蓘	gkum
蔉	gkun
璭	gkwm
惃	gkxm
鲧	gky
鯀	gkym
鮌	gkyn
謴	gkyo
擀	gla
赣	glb
疳	glbb
贛	glbm
凎	glbn
贑	glbo
泔	gle
淦	gleb
澉	glec
汵	glem
漧	glen
澸	gleo
灨	glep
绀	glf
紺	glfm
干	glg
甘	glgb
幹	glgm
骭	glgn
魐	glgo
秆	glh
稈	glhm
杆	gli
橄	glib
柑	glic
桿	glim
榦	glin
檊	glio
凲	gljm
竿	glk
衦	glkm
笴	glkn
筸	glko
篢	glkp
簳	glkq
肝	gll
盰	glmm
粓	glmn
姏	glnm
鳱	glnn
咁	glom
矸	glp
皯	glpm
酐	glq
旰	glr
坩	glt
苷	glu
芉	glum
乾	glv
仠	glvm
佄	glvn
乹	glvo
倝	glvp
亁	glvq
敢	glw
玕	glwm
攼	glwn
玵	glwo
尶	glwp
感	glx
忓	glxm
尴	gly
尷	glym
詌	glyn
尲	glyo
鳡	glyp
鱤	glyq
赶	glz
趕	glzm
迀	glzn
掴	goa
摑	goam
瘑	gobm
蝈	goc
蜾	gocb
蟈	gocm
輠	gocn
涡	goe
渦	goem
淉	goen
漍	goeo
濄	goep
郭	gof
聒	gofb
聝	gofm
綶	gofn
彉	gogm
彍	gogn
虢	goh
果	goi
椁	goib
槨	goim
楇	goin
櫎	goio
锅	goj
帼	gojb
鍋	gojm
幗	gojn
鈛	gojo
鐹	gojp
裹	gok
褁	gokm
簂	gokn
腂	golm
腘	goln
膕	golo
粿	gomm
矌	gomn
呙	goo
咼	goom
咶	goon
喐	gooo
啯	goop
嘓	gooq
猓	goq
崞	gos
馘	gosb
馃	gosm
餜	gosn
埚	got
堝	gotm
墎	gotn
菓	goum
蔮	goun
国	gow
囗	gowb
國	gowm
囯	gown
囶	gowo
囻	gowp
圀	gowq
敋	gowr
惈	goxm
慖	goxn
懖	goxo
过	goz
過	gozm
给	gpf
給	gpfm
挄	gqam
撗	gqan
臦	gqcm
輄	gqcn
臩	gqco
洸	gqem
广	gqg
廣	gqgm
広	gqgn
灮	gqhm
炗	gqhn
炚	gqho
炛	gqhp
烡	gqhq
黆	gqhr
桄	gqi
欟	gqim
銧	gqjm
胱	gql
姯	gqnm
咣	gqo
硄	gqpm
犷	gqq
獷	gqqm
垙	gqtm
茪	gqum
侊	gqvm
俇	gqvn
僙	gqvo
珖	gqwm
光	gqx
逛	gqz
掼	gra
摜	gram
关	grb
官	grbb
贯	grbc
貫	grbm
卝	grbn
痯	grbo
瘝	grbp
癏	grbq
輨	grcm
灌	gre
涫	greb
泴	grem
淉	gren
潅	greo
罐	grf
纶	grfb
綸	grfm
罆	grfn
爟	grhm
棺	gri
樌	grim
欟	grin
观	grj
觀	grjm
覌	grjn
錧	grjo
観	grjp
鏆	grjq
鑵	grjr
管	grk
筦	grkm
丱	grlm
冠	grm
矜	grmb
盥	grmc
關	grmm
毌	grmn
矝	grmo
閞	grmp
関	grmq
闗	grmr
矔	grms
鹳	grn
鸛	grnm
礶	grpm
馆	grs
館	grsm
豘	grsn
祼	grso
莞	gru
蒄	grum
倌	grv
舘	grvm
琯	grwm
璭	grwn
瓘	grwo
惯	grx
慣	grxm
悺	grxn
悹	grxo
窤	grxp
鳏	gry
鰥	grym
鳤	gryn
鱞	gryo
鱹	gryp
遦	grzm
雚	grzn
躀	grzo
拱	gsa
拲	gsam
公	gsb
宫	gsbb
共	gsbc
贡	gsbd
貢	gsbm
宮	gsbn
贛	gsbo
匑	gsbp
匔	gsbq
髸	gsbr
蚣	gsc
輁	gscm
汞	gse
澒	gsem
红	gsf
紅	gsfm
糼	gsfn
糿	gsfo
工	gsg
弓	gsgb
巩	gsgc
廾	gsgd
鞏	gsgm
熕	gshm
杛	gsim
栱	gsin
觥	gsj
幊	gsjm
銾	gsjn
觵	gsjo
兝	gskm
兣	gskn
篢	gsko
功	gsl
龚	gslb
肱	gslc
龔	gslm
龏	gsln
唝	gsom
嗊	gson
碽	gspm
躬	gss
厷	gssm
躳	gssn
塨	gstm
供	gsv
侊	gsvm
攻	gsw
珙	gswb
恭	gsx
愩	gsxm
慐	gsxn
羾	gsym
扢	guam
抇	guan
贾	gub
痼	gubb
賈	gubm
凅	gubn
蛊	guc
轱	gucb
蛄	gucc
蠱	gucm
軲	gucn
轂	guco
蛌	gucp
軱	gucq
沽	gue
汩	gueb
泒	guem
淈	guen
濲	gueo
瀔	guep
縎	gufm
骨	gug
谷	gugb
鼓	gugc
鼔	gugm
稒	guhm
穀	guhn
梏	gui
杚	guim
柧	guin
棝	guio
榾	guip
榖	guiq
橭	guir
櫎	guis
锢	guj
钴	gujb
觚	gujc
錮	gujm
鈷	gujn
鈲	gujo
箍	guk
笟	gukm
箛	gukn
篐	guko
股	gul
臌	gulb
脵	gulm
瞽	gum
糓	gumm
盬	gumn
姑	gun
鸪	gunb
鹄	gunc
鹘	gund
牯	gune
牿	gunf
鴣	gunm
鵠	gunn
鶻	guno
嫴	gunp
古	guo
咕	guob
告	guoc
呱	guod
嘏	guoe
唂	guom
唃	guon
啒	guoo
嗗	guop
毂	gup
硲	gupm
皷	gupn
磆	gupo
皼	gupp
酤	guq
崮	gus
罟	gusb
峠	gusm
罛	gusn
崓	guso
馉	gusp
祻	gusq
餶	gusr
堌	gutm
菇	guu
菰	guub
苽	guum
蓇	guun
薣	guuo
估	guv
傦	guvm
僱	guvn
故	guw
固	guwb
辜	gux
怘	guxm
愲	guxn
顾	guy
诂	guyb
鲴	guyc
顧	guym
詁	guyn
鯝	guyo
羖	guyp
尳	guyq
鮕	guyr
孤	guz
雇	guzb
夃	guzm
逧	guzn
摫	gvam
撌	gvan
贵	gvb
癸	gvbb
皈	gvbc
宄	gvbd
貴	gvbm
癐	gvbn
轨	gvc
軌	gvcm
軓	gvcn
蛫	gvco
厬	gvcp
螝	gvcq
蟡	gvcr
刽	gvd
刿	gvdb
劊	gvdm
劌	gvdn
氿	gvem
湀	gven
溎	gveo
潙	gvep
匦	gvf
匭	gvfm
匱	gvfn
邽	gvfo
陒	gvfp
郌	gvfq
鬼	gvg
龟	gvgb
庋	gvgc
龜	gvgm
庪	gvgn
亀	gvgo
廆	gvgp
鬶	gvgq
鬹	gvgr
鞼	gvgs
炅	gvh
柜	gvi
桂	gvib
桧	gvic
櫃	gvim
檜	gvin
朹	gvio
椝	gvip
椢	gviq
槼	gvir
槻	gvis
槶	gvit
槣	gviu
樻	gviv
櫰	gviw
櫷	gvix
规	gvj
規	gvjm
帰	gvjn
觤	gvjo
鐀	gvjp
鑎	gvjq
簋	gvk
袿	gvkm
筀	gvkn
簂	gvko
襘	gvkp
胿	gvlm
闺	gvm
閨	gvmm
瞆	gvmn
瞡	gvmo
瞶	gvmp
騩	gvmq
妫	gvn
媯	gvnm
姽	gvnn
嫢	gvno
鳺	gvnp
嬀	gvnq
硅	gvp
硊	gvpm
猤	gvqm
晷	gvr
昋	gvrm
祪	gvsm
嶡	gvsn
嶲	gvso
禬	gvsp
巂	gvsq
圭	gvt
垝	gvtm
茥	gvum
蓕	gvun
蘬	gvuo
佹	gvvm
瑰	gvw
珪	gvwm
璝	gvwn
瓌	gvwo
归	gvx
恑	gvxm
窐	gvxn
诡	gvy
鲑	gvyb
鳜	gvyc
詭	gvym
鮭	gvyn
鱖	gvyo
鱥	gvyp
跪	gvz
歸	gvzm
攰	gvzn
攱	gvzo
趹	gvzp
雟	gvzq
挂	gwa
括	gwab
掛	gwam
寡	gwb
卦	gwbb
刮	gwd
剐	gwdb
剮	gwdm
劀	gwdn
颪	gwfm
絓	gwfn
緺	gwfo
颳	gwfp
瓜	gwg
煱	gwhm
栝	gwi
桰	gwim
铦	gwjm
銛	gwjn
銽	gwjo
褂	gwk
袿	gwkm
胍	gwl
騧	gwmm
鸹	gwn
鴰	gwnm
呱	gwo
咼	gwom
叧	gwon
啩	gwoo
歄	gwqm
罣	gwsm
罫	gwsn
冎	gwtm
坬	gwtn
苽	gwum
诖	gwy
詿	gwym
諣	gwyn
趏	gwzm
踻	gwzn
拐	gya
掴	gyab
摑	gyam
夬	gydm
枴	gyim
柺	gyin
箉	gykm
乖	gyp
罫	gysm
怪	gyx
恠	gyxm
叏	gyym
挭	gzam
賡	gzbm
刯	gzdm
亙	gzem
浭	gzen
耿	gzf
绠	gzfb
綆	gzfm
郠	gzfn
絙	gzfo
絚	gzfp
縆	gzfq
緪	gzfr
庚	gzg
赓	gzgb
骾	gzgm
更	gzh
焿	gzhm
梗	gzi
椩	gzim
耕	gzl
鹒	gznm
鶊	gznn
哽	gzo
暅	gzrm
峺	gzsm
埂	gzt
畊	gztm
堩	gztn
莄	gzum
菮	gzun
羹	gzy
颈	gzyb
鲠	gzyc
羮	gzym
鯁	gzyn
頸	gzyo
虾	hac
蛤	hacb
蝦	hacm
奤	hadm
紦	hafm
铪	haj
鉿	hajm
哈	hao
乤	havm
皓	hcb
皐	hcbm
皞	hcbn
皜	hcbo
皡	hcbp
皥	hcbq
蚝	hcc
蠔	hccm
浩	hce
濠	hceb
灏	hcec
灝	hcem
淏	hcen
滜	hceo
滈	hcep
澔	hceq
郝	hcf
鄗	hcfm
聕	hcfn
號	hchm
秏	hchn
椃	hcim
镐	hcj
鎬	hcjm
兞	hckm
籇	hckn
耗	hcl
竓	hclm
毫	hcm
好	hcn
号	hco
嚎	hcob
嗥	hcoc
嚆	hcod
呺	hcom
哠	hcon
噑	hcoo
嘷	hcop
獆	hcqm
獔	hcqn
獋	hcqo
昊	hcr
昦	hcrm
晧	hcrn
暤	hcro
暠	hcrp
暭	hcrq
曍	hcrr
豪	hcs
壕	hct
蒿	hcu
薅	hcub
茠	hcum
薧	hcun
薃	hcuo
藃	hcup
乚	hcvm
侴	hcvn
傐	hcvo
儫	hcvp
悎	hcxm
恏	hcxn
颢	hcy
顥	hcym
諕	hcyn
鰝	hcyo
譹	hcyp
貉	hcz
臯	hczm
拸	hdam
害	hdb
海	hde
郂	hdfm
絯	hdfn
骸	hdg
烸	hdhm
胲	hdl
骇	hdm
駭	hdmm
駴	hdmn
妎	hdnm
嗨	hdo
咳	hdob
嘿	hdoc
咍	hdom
嗐	hdon
嚡	hdoo
氦	hdq
醢	hdqb
猲	hdqm
酼	hdqn
餀	hdsm
饚	hdsn
亥	hdt
塰	hdtm
侅	hdvm
还	hdz
孩	hdzb
還	hdzm
抲	heam
挌	hean
贺	heb
賀	hebm
寉	hebn
癋	hebo
皬	hebp
齃	hebq
赫	hec
蚵	hecb
龁	hecm
螛	hecn
齕	heco
蠚	hecp
河	hee
涸	heeb
渮	heem
澕	heen
纥	hef
紇	hefm
郃	hefn
鞨	hegm
和	heh
禾	hehb
焃	hehm
煂	hehn
熆	heho
熇	hehp
爀	hehq
燺	hehr
核	hei
柇	heim
楁	hein
釛	hejm
鉌	hejn
鑉	hejo
褐	hek
袔	hekm
篕	hekn
劾	hel
盒	hem
阖	hemb
阂	hemc
盍	hemd
閡	hemm
闔	hemn
盇	hemo
籺	hemp
盉	hemq
粭	hemr
毼	hems
麧	hemt
閤	hemu
鹤	hen
鶴	henm
鵠	henn
姀	heno
鹖	henp
穒	henq
鶡	henr
鶮	hens
鸖	hent
合	heo
呵	heob
喝	heoc
吓	heod
嗬	heoe
嚇	heom
咼	heon
咊	heoo
哬	heop
啝	heoq
喛	heor
嗃	heos
噈	heot
碋	hepm
礉	hepn
犵	heqm
狢	heqn
欱	heqo
猲	heqp
曷	her
朅	herm
靍	hern
靎	hero
靏	herp
峆	hesm
饸	hesn
餄	heso
餲	hesp
壑	het
垎	hetm
荷	heu
菏	heub
蓋	heum
萂	heun
何	hev
佫	hevm
敆	hewm
惒	hexm
覈	hexn
颌	hey
诃	heyb
翮	heyc
訶	heym
頜	heyn
訸	heyo
鲄	heyp
詥	heyq
魺	heyr
翯	heys
謞	heyt
龢	heyu
貉	hez
隺	hezm
貈	hezn
瘊	hfb
齁	hfbm
厚	hfc
後	hfcb
洉	hfem
郈	hffm
鄇	hffn
骺	hfg
帿	hfjm
銗	hfjn
鍭	hfjo
篌	hfk
腄	hflm
糇	hfm
睺	hfmm
后	hfo
吼	hfob
喉	hfoc
吽	hfom
呴	hfon
猴	hfq
犼	hfqm
矦	hfsm
豞	hfsn
餱	hfso
堠	hft
垕	hftm
茩	hfum
葔	hfun
候	hfv
侯	hfvb
鲎	hfy
詬	hfym
鱟	hfyn
鲘	hfyo
翭	hfyp
鮜	hfyq
翵	hfyr
鯸	hfys
逅	hfz
拫	hgam
痕	hgb
很	hgc
鵆	hgcm
鞎	hggm
噷	hgom
狠	hgq
佷	hgvm
恨	hgx
詪	hgym
貥	hhbm
行	hhc
蚢	hhcm
夯	hhd
沆	hhe
绗	hhf
絎	hhfm
邟	hhfn
斻	hhfo
骯	hhgm
杭	hhi
笐	hhkm
裄	hhkn
筕	hhko
妔	hhnm
吭	hho
巷	hhs
垳	hhtm
苀	hhum
忼	hhxm
颃	hhy
頏	hhym
魧	hhyn
航	hhz
迒	hhzm
掍	hkam
轋	hkcm
殙	hkdm
混	hke
浑	hkeb
溷	hkec
渾	hkem
湣	hken
涽	hkeo
湷	hkep
緄	hkfm
繉	hkfn
魂	hkg
焄	hkhm
焝	hkhn
棔	hkim
觨	hkjm
阍	hkm
閽	hkmm
眃	hkmn
睧	hkmo
睴	hkmp
睯	hkmq
婚	hkn
婫	hknm
昏	hkr
昬	hkrm
馄	hks
餛	hksm
餫	hksn
鼲	hkso
荤	hku
葷	hkum
蔒	hkun
俒	hkvm
倱	hkvn
珲	hkw
琿	hkwm
圂	hkwn
忶	hkxm
惛	hkxn
惽	hkxo
尡	hkxp
慁	hkxq
诨	hky
諢	hkym
撼	hla
捍	hlab
撖	hlac
扞	hlam
寒	hlb
鼾	hlbb
兯	hlbm
皔	hlbn
蚶	hlc
厈	hlcm
虷	hlcn
蛿	hlco
蜭	hlcp
蜬	hlcq
輚	hlcr
螒	hlcs
鬫	hldm
汉	hle
汗	hleb
涵	hlec
瀚	hled
漢	hlem
汵	hlen
涆	hleo
浛	hlep
浫	hleq
澏	hler
邯	hlf
邗	hlfb
甝	hlgm
谽	hlgn
豃	hlgo
焊	hlh
焓	hlhb
熯	hlhm
梒	hlim
椷	hlin
榦	hlio
釬	hljm
銲	hljn
鋡	hljo
鋎	hljp
函	hlk
凾	hlkm
笒	hlkn
筨	hlko
肣	hllm
罕	hlm
阚	hlmb
闞	hlmm
闬	hlmn
閈	hlmo
睅	hlmp
馯	hlmq
駻	hlmr
娢	hlnm
鳱	hlnn
嫨	hlno
鶾	hlnp
含	hlo
喊	hlob
哻	hlom
唅	hlon
酣	hlq
犴	hlqb
猂	hlqm
歛	hlqn
旱	hlr
晗	hlrb
晘	hlrm
晥	hlrn
暵	hlro
屽	hlsm
崡	hlsn
嵅	hlso
垾	hltm
菡	hlu
莟	hlum
蔊	hlun
仠	hlvm
佄	hlvn
傼	hlvo
韩	hlw
韓	hlwm
攼	hlwn
圅	hlwo
琀	hlwp
悍	hlx
憾	hlxb
憨	hlxc
忓	hlxm
馠	hlxn
翰	hly
颔	hlyb
顸	hlyc
頇	hlym
頷	hlyn
魽	hlyo
顄	hlyp
譀	hlyq
爳	hlzm
雗	hlzn
噷	hmom
攉	hoa
捇	hoam
掝	hoan
擭	hoao
货	hob
貨	hobm
癨	hobn
蠖	hoc
劐	hod
剨	hodm
奯	hodn
活	hoe
沎	hoem
湱	hoen
漷	hoeo
濩	hoep
濊	hoeq
瀖	hoer
邩	hofm
或	hog
豁	hogb
韄	hogm
火	hoh
和	hohb
灬	hohc
秮	hohm
秳	hohn
秴	hoho
煷	hohp
穫	hohq
檴	hoim
钬	hoj
镬	hojb
锪	hojc
鈥	hojm
鍃	hojn
鑊	hojo
旤	hojp
篧	hokm
耠	hol
膕	holm
耯	holn
臛	holo
眓	homm
閄	homn
矆	homo
騞	homp
矐	homq
姡	honm
嚯	hoo
吙	hoom
咊	hoon
咟	hooo
喐	hoop
嗀	hooq
嚄	hoor
嚿	hoos
乊	hopm
礊	hopn
獲	hoqm
霍	hor
曤	horm
靃	horn
祸	hos
禍	hosm
豰	hosn
获	hou
藿	houb
蒦	houm
伙	hov
佸	hovm
俰	hovn
惑	hox
夥	hoxb
窢	hoxm
彟	hoxn
彠	hoxo
謋	hoym
趏	hozm
雘	hozn
艧	hozo
潶	hpem
黑	hph
黒	hphm
嘿	hpo
嗨	hpob
揘	hqam
皇	hqb
癀	hqbb
宺	hqbm
皝	hqbn
皩	hqbo
蝗	hqc
徨	hqcb
蟥	hqcc
巟	hqcm
奛	hqdm
潢	hqe
湟	hqeb
汻	hqem
滉	hqen
兤	hqeo
隍	hqf
縨	hqfm
黄	hqh
煌	hqhb
黃	hqhm
炾	hqhn
熀	hqho
熿	hqhp
穔	hqhq
爌	hqhr
楻	hqim
榥	hqin
櫎	hqio
凰	hqj
幌	hqjb
锽	hqjm
鍠	hqjn
鎤	hqjo
鐄	hqjp
簧	hqk
篁	hqkb
肓	hql
朚	hqlm
騜	hqmm
媓	hqnm
鷬	hqnn
喤	hqom
磺	hqp
獚	hqqm
晃	hqr
晄	hqrm
曂	hqrn
崲	hqsm
餭	hqsn
塃	hqtm
堭	hqtn
墴	hqto
荒	hqu
葟	hqum
偟	hqvm
璜	hqw
瑝	hqwm
慌	hqx
恍	hqxb
惶	hqxc
怳	hqxm
衁	hqxn
愰	hqxo
谎	hqy
鳇	hqyb
謊	hqym
鰉	hqyn
詤	hqyo
諻	hqyp
韹	hqyq
鱑	hqyr
遑	hqz
艎	hqzm
趪	hqzn
换	hra
擐	hrab
換	hram
攌	hran
宦	hrb
寰	hrbb
鬟	hrbc
痪	hrbd
瘓	hrbm
寏	hrbn
轘	hrcm
奂	hrd
奐	hrdm
涣	hre
浣	hreb
洹	hrec
漶	hred
渙	hrem
潅	hren
澣	hreo
澴	hrep
缓	hrf
缳	hrfb
郇	hrfc
緩	hrfm
繯	hrfn
絙	hrfo
綄	hrfp
酄	hrfq
焕	hrh
煥	hrhm
烉	hrhn
桓	hri
梙	hrim
槵	hrin
锾	hrj
鍰	hrjm
镮	hrjn
鐶	hrjo
肒	hrlm
睆	hrmm
瞏	hrmn
瞣	hrmo
阛	hrmp
糫	hrmq
闤	hrmr
驩	hrms
鴅	hrnm
嬛	hrnn
鹮	hrno
鵍	hrnp
孉	hrnq
唤	hro
喚	hrom
喛	hron
嚾	hroo
欢	hrq
獾	hrqb
歡	hrqm
犿	hrqn
狟	hrqo
獂	hrqp
歓	hrqq
豢	hrs
峘	hrsm
嵈	hrsn
豩	hrso
豲	hrsp
堚	hrtm
萑	hru
荁	hrum
萈	hrun
蒝	hruo
藧	hrup
环	hrw
圜	hrwb
環	hrwm
瑍	hrwn
瓛	hrwo
患	hrx
愌	hrxm
懁	hrxn
懽	hrxo
幻	hry
鲩	hryb
鯇	hrym
羦	hryn
鰀	hryo
鯶	hryp
讙	hryq
还	hrz
逭	hrzb
還	hrzm
雈	hrzn
貆	hrzo
雚	hrzp
貛	hrzq
揈	hsam
撔	hsan
宏	hsb
訇	hsbb
宖	hsbm
轰	hsc
虹	hscb
轟	hscm
軣	hscn
輷	hsco
鬨	hsdm
洪	hse
泓	hseb
汯	hsem
沗	hsen
浲	hseo
浤	hsep
渱	hseq
溄	hser
渹	hses
潂	hset
澒	hseu
澋	hsev
红	hsf
紅	hsfm
纮	hsfn
耾	hsfo
紘	hsfp
紭	hsfq
綋	hsfr
弘	hsg
谹	hsgm
谼	hsgn
鞃	hsgo
谾	hsgp
彋	hsgq
烘	hsh
黉	hshb
黌	hshm
灴	hshn
焢	hsho
鈜	hsjm
鉷	hsjn
銾	hsjo
鋐	hsjp
鍧	hsjq
篊	hskm
竑	hslm
竤	hsln
闳	hsm
閎	hsmm
粠	hsmn
閧	hsmo
闂	hsmp
闀	hsmq
鸿	hsn
鴻	hsnm
妅	hsnn
娂	hsno
哄	hso
叿	hsom
呍	hson
吰	hsoo
吽	hsop
唝	hsoq
嗊	hsor
嚝	hsos
硔	hspm
硡	hspn
晎	hsrm
霐	hsrn
霟	hsro
厷	hssm
屸	hssn
巆	hsso
垬	hstm
薨	hsu
荭	hsub
蕻	hsuc
葒	hsum
苰	hsun
葓	hsuo
仜	hsvm
玒	hswm
瓨	hswn
玜	hswo
愩	hsxm
慐	hsxn
讧	hsy
訌	hsym
羾	hsyn
翃	hsyo
翝	hsyp
魟	hsyq
护	hua
抇	huam
搰	huan
摢	huao
冱	hub
冴	hubm
寣	hubn
鬍	hubo
蝴	huc
轷	hucb
軤	hucm
衚	hucn
螜	huco
湖	hue
沪	hueb
浒	huec
滹	hued
滬	huem
滸	huen
沍	hueo
汻	huep
泘	hueq
淲	huer
淴	hues
淈	huet
濩	hueu
瀫	huev
匢	hufm
匫	hufn
絗	hufo
綔	hufp
鄠	hufq
縎	hufr
縠	hufs
弧	hug
瓠	hugb
戏	hugc
戲	hugm
弖	hugn
瓡	hugo
戯	hugp
戱	hugq
韄	hugr
虎	huh
互	huhb
户	huhc
和	huhd
扈	huhe
戽	huhf
煳	huhg
烀	huhh
虍	huhi
戶	huhm
戸	huhn
虖	huho
焀	huhp
虝	huhq
熩	huhr
槲	hui
核	huib
枑	huim
楛	huin
楜	huio
槴	huip
斛	huj
帍	hujm
幠	hujn
錿	hujo
鍸	hujp
鍙	hujq
觷	hujr
笏	huk
箎	hukm
箶	hukn
簄	huko
胡	hul
膴	hulm
糊	hum
粐	humm
鹄	hun
鹘	hunb
鹕	hunc
鹱	hund
鵠	hunm
鶘	hunn
鶻	huno
鸌	hunp
姱	hunq
婟	hunr
媩	huns
嫮	hunt
嫭	hunu
鳸	hunv
鶦	hunw
鶮	hunx
呼	huo
唬	huob
唿	huoc
咊	huom
喖	huon
嗀	huoo
嗃	huop
嘑	huoq
嘝	huor
嚛	huos
乎	hup
觳	hupb
乕	hupm
礐	hupn
狐	huq
醐	huqb
猢	huqc
歑	huqm
昒	hurm
昈	hurn
曶	huro
雽	hurp
壶	hus
祜	husb
岵	husc
壺	husm
壷	husn
豰	huso
餬	husp
垀	hutm
葫	huu
芐	huum
苸	huun
芔	huuo
萀	huup
蔛	huuq
蔰	huur
乯	huvm
俿	huvn
僱	huvo
瑚	huw
琥	huwb
囫	huwc
瓳	huwm
忽	hux
惚	huxb
怙	huxc
怘	huxm
恗	huxn
许	huy
許	huym
護	huyn
魱	huyo
頶	huyp
謼	huyq
鯱	huyr
鰗	huys
鳠	huyt
頀	huyu
鱯	huyv
隺	huzm
雐	huzn
挥	hva
揮	hvam
拻	hvan
撝	hvao
贿	hvb
賄	hvbm
痐	hvbn
瘣	hvbo
寭	hvbp
辉	hvc
徽	hvcb
徊	hvcc
蛔	hvcd
虺	hvce
蟪	hvcf
輝	hvcm
蟲	hvcn
蚘	hvco
蛕	hvcp
蜖	hvcq
輠	hvcr
螝	hvcs
徻	hvct
殨	hvdm
汇	hve
溃	hveb
洄	hvec
潰	hvem
澮	hven
泋	hveo
洃	hvep
湏	hveq
滙	hver
潓	hves
濊	hvet
瀈	hveu
绘	hvf
隳	hvfb
缋	hvfc
匯	hvfm
繪	hvfn
繢	hvfo
隓	hvfp
絵	hvfq
戲	hvgm
廆	hvgn
戯	hvgo
灰	hvh
秽	hvhb
烩	hvhc
燴	hvhm
穢	hvhn
煒	hvho
灳	hvhp
烠	hvhq
烣	hvhr
煇	hvhs
燬	hvht
桧	hvi
檜	hvim
楎	hvin
椲	hvio
槥	hvip
橞	hviq
檅	hvir
檓	hvis
櫘	hvit
幑	hvjm
銊	hvjn
鏸	hvjo
鐬	hvjp
袆	hvkm
褘	hvkn
篲	hvko
襘	hvkp
麾	hvm
阓	hvmm
睳	hvmn
瞺	hvmo
闠	hvmp
靧	hvmq
婎	hvnm
媈	hvnn
嬒	hvno
孈	hvnp
喙	hvo
咴	hvob
噅	hvom
噦	hvon
嘒	hvoo
噕	hvop
嚖	hvoq
毁	hvp
毀	hvpm
硊	hvpn
毇	hvpo
獩	hvqm
晖	hvr
晦	hvrb
會	hvrm
暉	hvrn
暳	hvro
卉	hvs
屶	hvsm
屷	hvsn
叀	hvso
豗	hvsp
禈	hvsq
餯	hvsr
墮	hvtm
囘	hvtn
荟	hvu
茴	hvub
蕙	hvuc
薈	hvum
芔	hvun
蔧	hvuo
薉	hvup
藱	hvuq
蘳	hvur
会	hvv
佪	hvvm
僡	hvvn
儶	hvvo
回	hvw
珲	hvwb
琿	hvwm
囬	hvwn
圚	hvwo
璤	hvwp
璯	hvwq
恢	hvx
慧	hvxb
悔	hvxc
惠	hvxd
彗	hvxe
恚	hvxf
恛	hvxm
恵	hvxn
彚	hvxo
彙	hvxp
憓	hvxq
懳	hvxr
诲	hvy
讳	hvyb
诙	hvyc
誨	hvym
諱	hvyn
詼	hvyo
廻	hvyp
廽	hvyq
翙	hvyr
翚	hvys
颒	hvyt
詯	hvyu
翬	hvyv
頮	hvyw
鮰	hvyx
翽	hvyy
譓	hvyz
迴	hvzm
逥	hvzn
撶	hwam
搳	hwan
摦	hwao
螖	hwcm
划	hwd
劃	hwdm
夻	hwdn
滑	hwe
澅	hwem
繣	hwfm
黊	hwhm
桦	hwi
樺	hwim
杹	hwin
枠	hwio
椛	hwip
槬	hwiq
铧	hwj
鏵	hwjm
釪	hwjn
釫	hwjo
觟	hwjp
錵	hwjq
鋘	hwjr
骅	hwm
驊	hwmm
糀	hwmn
姡	hwnm
婲	hwnn
婳	hwno
嬅	hwnp
嫿	hwnq
鷨	hwnr
哗	hwo
嘩	hwom
呚	hwon
吪	hwoo
砉	hwp
硴	hwpm
磆	hwpn
猾	hwq
华	hws
崋	hwsm
舙	hwsn
画	hwt
畫	hwtm
埖	hwtn
畵	hwto
花	hwu
華	hwum
芲	hwun
蕐	hwuo
蘤	hwup
化	hwv
话	hwy
話	hwym
鮭	hwyn
誮	hwyo
魤	hwyp
諣	hwyq
諙	hwyr
譁	hwys
譮	hwyt
徊	hyc
划	hyd
劃	hydm
淮	hye
瀤	hyem
槐	hyi
櫰	hyim
褢	hykm
褱	hykn
耲	hylm
咶	hyom
坏	hyt
壞	hytm
壊	hytn
蘾	hyum
蘹	hyun
佪	hyvm
怀	hyx
懷	hyxm
懐	hyxn
踝	hyz
撗	hzam
衡	hzc
鵆	hzcm
涥	hzem
烆	hzhm
横	hzi
桁	hzib
橫	hzim
鑅	hzjm
胻	hzlm
脝	hzln
姮	hznm
鸻	hznn
鴴	hzno
哼	hzo
啈	hzom
亨	hzt
蘅	hzu
佷	hzvm
珩	hzw
恒	hzx
恆	hzxm
悙	hzxn
譭	hzyw
顪	hzyx
鰴	hzyy
譿	hzyz
挲	iaa
挱	iaam
摋	iaan
痧	iab
髿	iabm
厦	iac
刹	iad
剎	iadm
沙	iae
濈	iaem
纱	iaf
紗	iafm
繌	iafn
繺	iafo
廈	iagm
煞	iah
杀	iai
杉	iaib
桬	iaim
榝	iain
樧	iaio
铩	iaj
鎩	iajm
帹	iajn
裟	iak
箑	iakm
粆	iamm
閯	iamn
閷	iamo
啥	iao
嗄	iaob
唼	iaoc
唦	iaom
啑	iaon
喢	iaoo
砂	iap
殺	iapm
硰	iapn
歃	iaq
猀	iaqm
霎	iar
莎	iau
萐	iaum
菨	iaun
蔱	iauo
傻	iav
乷	iavm
倽	iavn
儍	iavo
鲨	iay
鯊	iaym
翜	iayn
翣	iayo
魦	iayp
鯋	iayq
歰	iazm
捎	ica
勺	icb
髾	icbm
蛸	icc
輎	iccm
潲	ice
绍	icf
邵	icfb
紹	icfm
旓	icfn
綤	icfo
鞘	icg
弰	icgm
烧	ich
稍	ichb
燒	ichm
焼	ichn
梢	ici
杓	icib
柖	icim
卲	icjm
筲	ick
袑	ickm
劭	icl
睄	icmm
娋	icnm
哨	ico
召	icob
芍	icu
苕	icub
莦	icum
萷	icun
蕱	icuo
佋	icvm
玿	icwm
少	icx
韶	icy
鮹	icym
艄	icz
摋	idam
攦	idan
繺	idfm
骰	idg
筛	idk
篩	idkm
簁	idkn
簛	idko
籭	idkp
閷	idmm
酾	idq
釃	idqm
晒	idr
曬	idrm
色	ids
諰	idym
摄	iea
折	ieab
揲	ieac
攝	ieam
挕	iean
捨	ieao
摂	ieap
赊	ieb
賒	iebm
賖	iebn
蛇	iec
赦	iecb
厍	iecc
厙	iecm
虵	iecn
蛥	ieco
輋	iecp
蠂	iecq
奢	ied
奓	iedm
涉	iee
滠	ieeb
灄	ieem
泏	ieen
渉	ieeo
涻	ieep
弽	iegm
檨	ieim
欇	iein
麝	iel
阇	iemm
闍	iemn
騇	iemo
磼	iepm
猞	ieq
歙	ieqb
射	ies
社	iesb
舌	iesc
畲	iet
畬	ietm
畭	ietn
蔎	ieum
舍	iev
佘	ievb
舎	ievm
韘	iewm
慑	iex
懾	iexm
慴	iexn
设	iey
設	ieym
手	ifa
授	ifab
扌	ifac
守	ifb
兽	ifbb
瘦	ifbc
痩	ifbm
寿	ifc
涭	ifem
绶	iff
綬	iffm
熟	ifh
鏉	ifjm
膄	iflm
售	ifo
嘼	ifom
狩	ifq
獸	ifqm
獣	ifqn
首	ifs
壽	ifsm
夀	ifsn
垨	iftm
乺	ifvm
收	ifw
敊	ifwm
受	ify
収	ifym
艏	ifz
扟	igam
抌	igan
搷	igao
审	igb
審	igbm
瘆	igbn
瘮	igbo
蜃	igc
蜄	igcm
深	ige
沈	igeb
渗	igec
渖	iged
滲	igem
瀋	igen
涁	igeo
淰	igep
兟	igeq
绅	igf
紳	igfm
邥	igfn
綝	igfo
弞	iggm
矤	iggn
甚	igh
燊	ighm
黮	ighn
椹	igi
罙	igim
柛	igin
棯	igio
榊	igip
槮	igiq
鉮	igjm
幓	igjn
鋠	igjo
覾	igjp
裑	igkm
申	igl
肾	iglb
胂	iglc
腎	iglm
脤	igln
糁	igm
糝	igmm
籶	igmn
冞	igmo
籸	igmp
眘	igmq
眒	igmr
糂	igms
駪	igmt
瞫	igmu
糣	igmv
婶	ign
娠	ignb
嬸	ignm
妽	ignn
姺	igno
嫀	ignp
鵢	ignq
呻	igo
哂	igob
砷	igp
氠	igqm
昚	igrm
曋	igrn
曑	igro
身	igs
神	igsb
参	igsc
矧	igsd
參	igsm
屾	igsn
峷	igso
甡	igsp
祳	igsq
叄	igsr
叅	igss
罧	igst
甧	igsu
堔	igtm
莘	igu
葚	igub
葠	igum
蓡	igun
蔘	iguo
薓	igup
什	igv
伸	igvb
伔	igvm
侁	igvn
侺	igvo
珅	igwm
敒	igwn
慎	igx
穼	igxm
愼	igxn
诜	igy
谂	igyb
詵	igym
諗	igyn
谉	igyo
訠	igyp
訷	igyq
頣	igyr
魫	igys
鲹	igyt
鯓	igyu
鯵	igyv
鰰	igyw
鰺	igyx
讅	igyy
赏	ihb
賞	ihbm
贘	ihbn
螪	ihcm
蠰	ihcn
殇	ihd
殤	ihdm
汤	ihe
泷	iheb
湯	ihem
漡	ihen
滳	iheo
绱	ihf
緔	ihfm
鞝	ihgm
鬺	ihgn
上	ihh
熵	ihhb
丄	ihhm
扄	ihhn
樉	ihim
觞	ihj
觴	ihjm
鋿	ihjn
鏛	ihjo
鑜	ihjp
裳	ihk
商	iho
晌	ihr
禓	ihsm
墒	iht
垧	ihtb
埫	ihtm
塲	ihtn
蔏	ihum
伤	ihv
傷	ihvm
仩	ihvn
尚	ihx
尙	ihxm
恦	ihxn
愓	ihxo
慯	ihxp
謪	ihym
拾	iia
拭	iiab
揓	iiam
实	iib
室	iibb
匙	iibc
贳	iibd
實	iibm
貰	iibn
実	iibo
宩	iibp
宲	iibq
痑	iibr
寔	iibs
释	iic
蚀	iicb
轼	iicc
虱	iicd
螫	iice
蝕	iicm
釋	iicn
軾	iico
厔	iicp
釈	iicq
徥	iicr
蝨	iics
失	iid
殖	iidb
奭	iidm
湿	iie
澤	iiem
濕	iien
兘	iieo
浉	iiep
湜	iieq
湤	iier
溼	iies
溡	iiet
溮	iieu
澨	iiev
施	iif
邿	iifm
絁	iifn
事	iih
世	iihb
炻	iihc
丆	iihm
丗	iihn
亊	iiho
戺	iihp
烒	iihq
秲	iihr
煶	iihs
柿	iii
柹	iiim
枾	iiin
栻	iiio
楴	iiip
榁	iiiq
榯	iiir
檡	iiis
市	iij
视	iijb
师	iijc
铈	iijd
師	iijm
視	iijn
鈰	iijo
鎩	iijp
釶	iijq
觢	iijr
鉐	iijs
鉂	iijt
鉃	iiju
鉇	iijv
鉽	iijw
銴	iijx
鍉	iijy
鍦	iijz
筮	iik
兙	iikm
笶	iikn
篒	iiko
箷	iikp
褷	iikq
簭	iikr
籂	iiks
襫	iikt
襹	iiku
势	iil
勢	iilm
竍	iiln
驶	iim
駛	iimm
眂	iimn
冟	iimo
眎	iimp
眡	iimq
睗	iimr
馶	iims
始	iin
鸤	iinm
姼	iinn
鳲	iino
鳾	iinp
嬕	iinq
鶳	iinr
史	iio
噬	iiob
嘘	iioc
嗜	iiod
噓	iiom
呩	iion
呞	iioo
咶	iiop
啫	iioq
石	iip
尸	iipb
屎	iipc
屍	iipm
碩	iipn
狮	iiq
酾	iiqb
獅	iiqm
釃	iiqn
狧	iiqo
狶	iiqp
醳	iiqq
是	iir
时	iirb
時	iirm
旹	iirn
昰	iiro
十	iis
士	iisb
示	iisc
食	iisd
氏	iise
饰	iisf
矢	iisg
峙	iish
舐	iisi
豕	iisj
饣	iisk
礻	iisl
飾	iism
飭	iisn
卋	iiso
飠	iisp
峕	iisq
祏	iisr
崼	iiss
崻	iist
嵵	iisu
舓	iisv
餝	iisw
餙	iisx
鼫	iisy
鼭	iisz
埘	iit
塒	iitm
埶	iitn
畤	iito
莳	iiu
蓍	iiub
蒔	iium
葹	iiun
蒒	iiuo
使	iiv
似	iivb
侍	iivc
仕	iivd
什	iive
乭	iivm
乨	iivn
佦	iivo
瓧	iiwm
瑡	iiwn
恃	iix
忕	iixm
忯	iixn
恀	iixo
惿	iixp
试	iiy
式	iiyb
识	iiyc
诗	iiyd
誓	iiye
弑	iiyf
谥	iiyg
鲥	iiyh
鲺	iiyi
試	iiym
詩	iiyn
識	iiyo
弒	iiyp
謚	iiyq
鯴	iiyr
鰣	iiys
鮖	iiyt
諟	iiyu
諡	iiyv
鰘	iiyw
鰤	iiyx
适	iiz
逝	iizb
適	iizm
辻	iizn
遈	iizo
遰	iizp
遾	iizq
鬊	ikbm
巛	ikc
輴	ikcm
楯	ikim
橓	ikin
瞬	ikm
眴	ikmm
瞚	ikmn
瞤	ikmo
吮	iko
蕣	ikum
顺	iky
順	ikym
舜	ikz
擅	ila
掸	ilab
摻	ilam
撣	ilan
攙	ilao
挻	ilap
掞	ilaq
搧	ilar
赡	ilb
单	ilbb
疝	ilbc
髟	ilbd
贍	ilbm
痁	ilbn
蟮	ilc
軕	ilcm
蟺	ilcn
删	ild
剡	ildb
刪	ildm
剼	ildn
汕	ile
潸	ileb
澘	ilem
潬	ilen
灗	ileo
陕	ilf
缮	ilfb
鄯	ilfc
繕	ilfm
邖	ilfn
陝	ilfo
縿	ilfp
纔	ilfq
扇	ilh
煽	ilhb
炶	ilhm
煔	ilhn
熌	ilho
穇	ilhp
杉	ili
栅	ilib
柵	ilim
杣	ilin
椫	ilio
樿	ilip
檆	iliq
钐	ilj
釤	iljm
銏	iljn
幓	iljo
覢	iljp
鐥	iljq
衫	ilk
笘	ilkm
襂	ilkn
膳	ill
膻	illb
脠	illm
闪	ilm
骟	ilmb
閃	ilmm
騸	ilmn
閄	ilmo
閊	ilmp
睒	ilmq
姗	iln
嬗	ilnb
姍	ilnm
善	ilo
單	ilom
嘇	ilon
磰	ilpm
狦	ilqm
猭	ilqn
歚	ilqo
晱	ilrm
山	ils
禅	ilsb
彡	ilsc
禪	ilsm
単	ilsn
嶦	ilso
饍	ilsp
埏	ilt
圸	iltm
墠	iltn
墡	ilto
苫	ilu
芟	ilub
蔪	ilum
傓	ilvm
僤	ilvn
僐	ilvo
儃	ilvp
珊	ilw
敾	ilwm
讪	ily
鳝	ilyb
訕	ilym
鱔	ilyn
鯅	ilyo
謆	ilyp
羴	ilyq
羶	ilyr
譱	ilys
鳣	ilyt
鱓	ilyu
鱣	ilyv
跚	ilz
舢	ilzb
赸	ilzm
搠	ioa
洬	ioem
烁	ioh
爍	iohm
槊	ioi
铄	ioj
鑠	iojm
銏	iojn
鎙	iojo
箾	iokm
朔	iol
矟	iomm
妁	ion
硕	iop
碩	iopm
欶	ioqm
獡	ioqn
蒴	iou
数	iow
數	iowm
愬	ioxm
说	ioy
說	ioym
説	ioyn
谁	ipy
誰	ipym
爽	iqd
泷	iqe
瀧	iqem
滝	iqen
漺	iqeo
灀	iqep
縔	iqfm
樉	iqim
欆	iqin
鏯	iqjm
骦	iqmm
騻	iqmn
驦	iqmo
孀	iqn
孇	iqnm
鷞	iqnn
鹴	iqno
鸘	iqnp
礵	iqpm
霜	iqr
塽	iqtm
慡	iqxm
双	iqy
雙	iqzm
艭	iqzn
拴	ira
涮	ire
絟	irfm
栓	iri
槫	irim
腨	irlm
闩	irm
閂	irmm
抒	iua
摅	iuab
攄	iuam
捒	iuan
捈	iuao
掓	iuap
赎	iub
贖	iubm
癙	iubn
输	iuc
蜀	iucb
術	iucm
輸	iucn
軗	iuco
尌	iucp
蠴	iucq
殊	iud
豎	iudm
鼡	iudn
淑	iue
漱	iueb
沐	iuec
澍	iued
沭	iuee
潄	iuem
潻	iuen
濖	iueo
瀭	iuep
纾	iuf
紓	iufm
陎	iufn
鄃	iufo
隃	iufp
絉	iufq
綀	iufr
緰	iufs
庶	iug
戍	iugb
庻	iugm
熟	iuh
黍	iuhb
秫	iuhc
焂	iuhm
稌	iuhn
虪	iuho
术	iui
树	iuib
束	iuic
梳	iuid
枢	iuie
樞	iuim
樹	iuin
朮	iuio
杸	iuip
橾	iuiq
鉥	iujm
錰	iujn
鏣	iujo
裋	iukm
襡	iukn
襩	iuko
籔	iukp
竖	iul
丨	iulb
腧	iulc
竪	iulm
毹	ium
毺	iumm
氀	iumn
糬	iumo
姝	iun
婌	iunm
鶐	iunn
鵨	iuno
咰	iuom
属	iup
殳	iupb
屬	iupm
暑	iur
曙	iurb
書	iurm
兪	iurn
暏	iuro
霔	iurp
鼠	ius
署	iusb
墅	iut
塾	iutb
蔬	iuu
薯	iuub
菽	iuuc
荗	iuum
蒁	iuun
蒣	iuuo
薥	iuup
藷	iuuq
书	iuv
舒	iuvb
俞	iuvc
倏	iuvd
侸	iuvm
倐	iuvn
儵	iuvo
数	iuw
數	iuwm
琡	iuwn
瑹	iuwo
璹	iuwp
恕	iux
尗	iuxm
忬	iuxn
怸	iuxo
怷	iuxp
悆	iuxq
叔	iuy
鮛	iuym
鱰	iuyn
述	iuz
疏	iuzb
孰	iuzc
疋	iuzd
疎	iuzm
踈	iuzn
跾	iuzo
挩	ivam
捝	ivan
水	ive
氵	iveb
氺	ivem
涗	iven
涚	iveo
税	ivh
稅	ivhm
帨	ivjm
裞	ivkm
脽	ivlm
睡	ivm
閖	ivmm
娷	ivnm
祱	ivsm
谁	ivy
说	ivyb
誰	ivym
說	ivyn
説	ivyo
蜀	iwc
刷	iwd
耍	iwe
唰	iwo
誜	iwym
摔	iya
蟀	iyc
缞	iyfm
縗	iyfn
帅	iyj
帥	iyjm
衰	iyk
卛	iysm
率	iyx
甩	iyy
貹	izbm
賸	izbn
剩	izd
斘	izdm
殅	izdn
剰	izdo
渑	ize
澠	izem
泩	izen
渻	izeo
湦	izep
绳	izf
聖	izfm
聲	izfn
繩	izfo
阩	izfp
陞	izfq
陹	izfr
縄	izfs
繉	izft
焺	izhm
枡	izim
栍	izin
椉	izio
榺	izip
橳	iziq
鉎	izjm
鍟	izjn
笙	izk
胜	izl
勝	izlm
竔	izln
省	izm
盛	izmb
眚	izmc
牲	izn
娍	iznm
鵿	iznn
呏	izom
升	izp
乘	izpb
乗	izpm
殸	izpn
狌	izqm
晟	izr
昇	izrm
晠	izrn
曻	izro
生	izs
声	izsb
甥	izsc
嵊	izsd
鼪	izsm
圣	izt
墭	iztm
苼	izum
蕂	izun
偗	izvm
珄	izwm
琞	izwn
憴	izxm
譝	izym
掘	jga
撅	jgab
抉	jgac
攫	jgad
挗	jgam
捔	jgan
撧	jgao
决	jgb
疦	jgbm
瘚	jgbn
厥	jgc
虳	jgcm
蚗	jgcn
镼	jgco
蟨	jgcp
蟩	jgcq
劂	jgd
刔	jgdm
殌	jgdn
決	jgem
泬	jgen
灍	jgeo
绝	jgf
絕	jgfm
絶	jgfn
繘	jgfo
匷	jgfp
弡	jggm
髉	jggn
彏	jggo
爝	jgh
焳	jghm
熦	jghn
燋	jgho
爑	jghp
穱	jghq
橛	jgi
桷	jgib
橜	jgim
櫭	jgin
觉	jgj
角	jgjb
镢	jgjc
觖	jgjd
覺	jgjm
鐝	jgjn
覐	jgjo
鈌	jgjp
覚	jgjq
觮	jgjr
鐍	jgjs
觼	jgjt
钁	jgju
袦	jgkm
脚	jgl
臄	jglm
闕	jgmm
矞	jgmn
駃	jgmo
矡	jgmp
妜	jgnm
鴃	jgnn
鴂	jgno
鷢	jgnp
嚼	jgo
噘	jgob
噱	jgoc
吷	jgom
噊	jgon
砄	jgpm
瑴	jgpn
屩	jgpo
屫	jgpp
獗	jgq
欮	jgqm
玃	jgqn
崛	jgs
氒	jgsm
崫	jgsn
嶡	jgso
嶥	jgsp
埆	jgtm
壆	jgtn
蕨	jgu
芵	jgum
蕝	jgun
倔	jgv
亅	jgvm
傕	jgvn
珏	jgw
玨	jgwm
玦	jgwn
斍	jgwo
璚	jgwp
憰	jgxm
憠	jgxn
戄	jgxo
诀	jgy
谲	jgyb
矍	jgyc
廴	jgyd
訣	jgym
譎	jgyn
鱖	jgyo
叕	jgyp
誳	jgyq
爵	jgz
蹶	jgzb
孓	jgzc
孒	jgzm
赽	jgzn
趹	jgzo
趉	jgzp
爴	jgzq
蹷	jgzr
蹻	jgzs
躩	jgzt
貜	jgzu
技	jia
挤	jiab
掎	jiac
擠	jiam
擊	jian
揤	jiao
摖	jiap
撠	jiaq
撃	jiar
撽	jias
疾	jib
寂	jibb
寄	jibc
冀	jibd
髻	jibe
瘠	jibf
其	jibg
赍	jibh
賫	jibm
屰	jibn
皀	jibo
皍	jibp
痵	jibq
兾	jibr
賷	jibs
癠	jibt
癪	jibu
辑	jic
虮	jicb
輯	jicm
蟣	jicn
彶	jico
徛	jicp
蝍	jicq
螏	jicr
蠀	jics
轚	jict
剂	jid
奇	jidb
殛	jidc
剞	jidd
劑	jidm
刉	jidn
刏	jido
剤	jidp
济	jie
激	jieb
汲	jiec
洎	jied
濟	jiem
汥	jien
泲	jieo
済	jiep
淁	jieq
湒	jier
漈	jies
漃	jiet
濈	jieu
潗	jiev
瀱	jiew
级	jif
继	jifb
纪	jifc
际	jifd
绩	jife
缉	jiff
给	jifg
系	jifh
級	jifm
紀	jifn
給	jifo
際	jifp
緝	jifq
績	jifr
繼	jifs
郆	jift
紒	jifu
継	jifv
綨	jifw
緁	jifx
隮	jify
繋	jifz
既	jig
戟	jigb
革	jigc
戢	jigd
谻	jigm
庴	jign
鬾	jigo
鞊	jigp
廭	jigq
鞿	jigr
魕	jigs
积	jih
稽	jihb
稷	jihc
亟	jihd
嵇	jihe
丌	jihf
積	jihm
焏	jihn
稘	jiho
稩	jihp
穊	jihq
穄	jihr
穖	jihs
穧	jiht
机	jii
极	jiib
棘	jiic
楫	jiid
極	jiim
機	jiin
枅	jiio
楖	jiip
梞	jiiq
槉	jiir
樭	jiis
槣	jiit
橶	jiiu
檝	jiiv
檕	jiiw
櫅	jiix
櫭	jiiy
檵	jiiz
几	jij
己	jijb
即	jijc
觊	jijd
覘	jijm
覬	jijn
覿	jijo
旡	jijp
卽	jijq
觙	jijr
帺	jijs
旣	jijt
銈	jiju
銡	jijv
觭	jijw
錤	jijx
鍓	jijy
韲	jijz
击	jik
籍	jikb
笈	jikc
箕	jikd
笄	jike
筓	jikm
裚	jikn
箿	jiko
襀	jikp
簎	jikq
簊	jikr
襋	jiks
肌	jil
脊	jilb
期	jilc
麂	jild
丮	jilm
朞	jiln
勣	jilo
耤	jilp
膌	jilq
耭	jilr
骑	jim
骥	jimb
驥	jimm
瞉	jimn
鸡	jin
嫉	jinb
姬	jinc
妓	jind
犄	jine
乁	jinm
妀	jinn
姞	jino
鳮	jinp
鹡	jinq
鵋	jinr
鶏	jins
鷄	jint
鶺	jinu
鷑	jinv
鸄	jinw
吉	jio
叽	jiob
唧	jioc
咭	jiod
哜	jioe
嘰	jiom
嚌	jion
吇	jioo
喞	jiop
嗘	jioq
及	jip
矶	jipb
屐	jipc
磯	jipm
硛	jipn
毄	jipo
磼	jipp
齊	jiqm
齏	jiqn
犱	jiqo
齌	jiqp
齎	jiqq
霁	jir
暨	jirb
霽	jirm
暩	jirn
曁	jiro
霵	jirp
祭	jis
饥	jisb
羁	jisc
岌	jisd
嵴	jise
饑	jism
羈	jisn
岋	jiso
飢	jisp
卙	jisq
嵆	jisr
禝	jiss
嶯	jist
躸	jisu
禨	jisv
罽	jisw
羇	jisx
基	jit
圾	jitb
畿	jitc
畸	jitd
墼	jite
坖	jitm
垍	jitn
畟	jito
堲	jitp
塈	jitq
塉	jitr
藉	jiu
蓟	jiub
蒺	jiuc
芨	jiud
荠	jiue
芰	jiuf
蕺	jiug
茍	jium
薊	jiun
薺	jiuo
苙	jiup
茤	jiuq
葪	jiur
蔇	jius
蕀	jiut
蘎	jiuu
蘮	jiuv
蘻	jiuw
虀	jiux
伎	jiv
佶	jivb
偈	jivc
乩	jivd
亼	jivm
亽	jivn
伋	jivo
偮	jivp
僟	jivq
玑	jiw
齑	jiwb
璣	jiwm
敧	jiwn
璾	jiwo
急	jix
忌	jixb
悸	jixc
彑	jixm
尐	jixn
忣	jixo
惎	jixp
愱	jixq
憿	jixr
懠	jixs
懻	jixt
覉	jixu
覊	jixv
记	jiy
计	jiyb
讥	jiyc
诘	jiyd
鲫	jiye
鲚	jiyf
計	jiym
記	jiyn
幾	jiyo
譏	jiyp
詰	jiyq
鯽	jiyr
鱭	jiys
叝	jiyt
鱾	jiyu
魝	jiyv
魥	jiyw
魢	jiyx
誋	jiyy
諅	jiyz
集	jiz
迹	jizb
季	jizc
跻	jizd
跽	jize
跡	jizm
雞	jizn
躋	jizo
攲	jizp
臮	jizq
趌	jizr
趞	jizs
踑	jizt
踖	jizu
蹐	jizv
蹟	jizw
艥	jizx
躤	jizy
雧	jizz
捡	jja
拣	jjab
搛	jjac
揀	jjam
撿	jjan
挸	jjao
揵	jjap
揃	jjaq
擶	jjar
攕	jjas
减	jjb
兼	jjbb
贱	jjbc
賤	jjbm
冿	jjbn
寋	jjbo
賎	jjbp
鬋	jjbq
徤	jjcm
螹	jjcn
蠒	jjco
轞	jjcp
剑	jjd
歼	jjdb
剪	jjdc
劍	jjdm
殲	jjdn
剣	jjdo
剱	jjdp
劎	jjdq
劒	jjdr
劔	jjds
殱	jjdt
劗	jjdu
渐	jje
浅	jjeb
溅	jjec
涧	jjed
湔	jjee
淺	jjem
減	jjen
漸	jjeo
澗	jjep
濺	jjeq
洊	jjer
湕	jjes
瀐	jjet
瀳	jjeu
瀸	jjev
瀽	jjew
缄	jjf
缣	jjfb
緘	jjfm
繭	jjfn
縑	jjfo
旔	jjfp
絸	jjfq
繝	jjfr
聻	jjfs
艰	jjg
戬	jjgb
鞯	jjgc
戋	jjgd
艱	jjgm
戔	jjgn
戩	jjgo
韉	jjgp
幵	jjgq
靬	jjgr
弿	jjgs
彅	jjgt
鞬	jjgu
韀	jjgv
煎	jjh
稴	jjhm
熞	jjhn
熸	jjho
检	jji
柬	jjib
槛	jjic
楗	jjid
枧	jjie
檢	jjim
檻	jjin
梘	jjio
栫	jjip
検	jjiq
椷	jjir
椾	jjis
榗	jjit
樫	jjiu
橏	jjiv
櫼	jjiw
见	jjj
键	jjjb
鉴	jjjc
锏	jjjd
見	jjjm
鍵	jjjn
鑒	jjjo
鐧	jjjp
帴	jjjq
釰	jjjr
釼	jjjs
鋄	jjjt
鋑	jjju
鋻	jjjv
鍳	jjjw
鎫	jjjx
覸	jjjy
覵	jjjz
简	jjk
箭	jjkb
笺	jjkc
笕	jjkd
裥	jjke
箋	jjkm
簡	jjkn
筧	jjko
襇	jjkp
袸	jjkq
篯	jjkr
襉	jjks
籈	jjkt
籛	jjku
襺	jjkv
肩	jjl
腱	jjlb
鹹	jjlm
鹼	jjln
麉	jjlo
鹸	jjlp
鹻	jjlq
间	jjm
监	jjmb
睑	jjmc
毽	jjmd
間	jjmm
監	jjmn
瞼	jjmo
閒	jjmp
睷	jjmq
糋	jjmr
瞷	jjms
瞯	jjmt
奸	jjn
犍	jjnb
鹣	jjnc
牮	jjnd
鵑	jjnm
鶼	jjnn
姧	jjno
姦	jjnp
鳽	jjnq
鵳	jjnr
囏	jjom
碱	jjp
硷	jjpb
牋	jjpm
碊	jjpn
磵	jjpo
礀	jjpp
礆	jjpq
礛	jjpr
礷	jjps
猏	jjqm
朁	jjrm
暕	jjrn
饯	jjs
餞	jjsm
豜	jjsn
豣	jjso
餰	jjsp
坚	jjt
堅	jjtm
堿	jjtn
塹	jjto
墹	jjtp
荐	jju
茧	jjub
菅	jjuc
蒹	jjud
薦	jjum
菺	jjun
葌	jjuo
蔪	jjup
蕳	jjuq
蕑	jjur
藆	jjus
虃	jjut
件	jjv
健	jjvb
俭	jjvc
僭	jjvd
儉	jjvm
俴	jjvn
倹	jjvo
偂	jjvp
傔	jjvq
僣	jjvr
囝	jjw
玪	jjwm
珔	jjwn
瑊	jjwo
瑐	jjwp
尖	jjx
惤	jjxm
馢	jjxn
建	jjy
谏	jjyb
翦	jjyc
謇	jjyd
鲣	jjye
谫	jjyf
諫	jjym
鰹	jjyn
譾	jjyo
詃	jjyp
諓	jjyq
鳒	jjyr
謭	jjys
鰎	jjyt
譛	jjyu
鰔	jjyv
譼	jjyw
鰜	jjyx
舰	jjz
践	jjzb
蹇	jjzc
踺	jjzd
趼	jjze
踐	jjzm
艦	jjzn
雃	jjzo
臶	jjzp
跈	jjzq
趝	jjzr
捃	jka
攈	jkam
攟	jkan
賐	jkbm
寯	jkbn
軍	jkcm
蚐	jkcn
蜠	jkco
浚	jke
汮	jkem
濬	jken
郡	jkf
陖	jkfm
龟	jkg
龜	jkgm
焌	jkhm
燇	jkhn
桾	jkim
棞	jkin
钧	jkj
鈞	jkjm
銁	jkjn
銞	jkjo
覠	jkjp
鍕	jkjq
筠	jkk
袀	jkkm
箟	jkkn
箘	jkko
竣	jkl
麇	jklb
麏	jklm
麕	jkln
军	jkm
骏	jkmb
駿	jkmm
姰	jknm
鵔	jknn
鵘	jkno
鵕	jknp
君	jko
呁	jkom
皲	jkp
皸	jkpm
碅	jkpn
皹	jkpo
晙	jkrm
峻	jks
馂	jksm
餕	jksn
均	jkt
埈	jktm
畯	jktn
菌	jku
莙	jkum
葰	jkun
蔨	jkuo
俊	jkv
儁	jkvm
珺	jkwm
懏	jkxm
鲪	jkym
頵	jkyn
鮶	jkyo
隽	jkz
雋	jkzm
搅	jma
挢	jmab
攪	jmam
撟	jman
挍	jmao
捁	jmap
摎	jmaq
摷	jmar
撹	jmas
皎	jmb
賋	jmbm
癄	jmbn
皦	jmbo
皭	jmbp
较	jmc
蛟	jmcb
轿	jmcc
徼	jmcd
較	jmcm
轎	jmcn
徺	jmco
轇	jmcp
蟜	jmcq
蟭	jmcr
剿	jmd
斠	jmdm
劋	jmdn
浇	jme
湫	jmeb
澆	jmem
湬	jmen
滘	jmeo
漖	jmep
潐	jmeq
灂	jmer
灚	jmes
绞	jmf
郊	jmfb
缴	jmfc
絞	jmfm
繳	jmfn
纐	jmfo
焦	jmh
爝	jmhb
烄	jmhm
煍	jmhn
虠	jmho
燋	jmhp
穚	jmhq
校	jmi
椒	jmib
樔	jmim
角	jmj
觉	jmjb
铰	jmjc
鉸	jmjm
覺	jmjn
覐	jmjo
釥	jmjp
覚	jmjq
鐎	jmjr
笅	jmkm
筊	jmkn
簥	jmko
脚	jml
胶	jmlb
腳	jmlm
膠	jmln
勦	jmlo
膲	jmlp
骄	jmm
驕	jmmm
娇	jmn
姣	jmnb
鹪	jmnc
嬌	jmnm
鷦	jmnn
嬓	jmno
鵁	jmnp
鵤	jmnq
孂	jmnr
鷮	jmns
叫	jmo
嚼	jmob
噍	jmoc
喬	jmom
呌	jmon
嘂	jmoo
嘄	jmop
嘦	jmoq
嘐	jmor
噭	jmos
礁	jmp
狡	jmq
酵	jmqb
醮	jmqc
獥	jmqm
釂	jmqn
晈	jmrm
暞	jmrn
曒	jmro
矫	jms
饺	jmsb
峤	jmsc
餃	jmsm
矯	jmsn
嶠	jmso
峧	jmsp
嶕	jmsq
嶣	jmsr
交	jmt
蕉	jmu
茭	jmub
艽	jmuc
茮	jmum
藠	jmun
侥	jmv
佼	jmvb
僬	jmvc
僥	jmvm
儌	jmvn
教	jmw
敫	jmwb
珓	jmwm
敎	jmwn
斍	jmwo
敽	jmwp
敿	jmwq
璬	jmwr
窖	jmx
恔	jmxm
悎	jmxn
窌	jmxo
憢	jmxp
憍	jmxq
憿	jmxr
鲛	jmy
鮫	jmym
訆	jmyn
譑	jmyo
譥	jmyp
鱎	jmyq
龣	jmyr
跤	jmz
臫	jmzm
踋	jmzn
趭	jmzo
揪	jna
捄	jnam
揂	jnan
揫	jnao
摎	jnap
疚	jnb
鬏	jnbb
勼	jnbm
匓	jnbn
厩	jnc
镹	jncm
齨	jncn
鬮	jndm
剹	jndn
殧	jndo
酒	jne
氿	jnem
汣	jnen
纠	jnf
糾	jnfm
匛	jnfn
糺	jnfo
紤	jnfp
匶	jnfq
廄	jngm
廐	jngn
廏	jngo
灸	jnh
稵	jnhm
柩	jni
桕	jnib
朻	jnim
杦	jnin
柾	jnio
樛	jnip
欍	jniq
舅	jnj
臼	jnjb
韭	jnjc
舊	jnjm
韮	jnjn
丩	jnlm
麔	jnln
阄	jnm
鹫	jnn
鸠	jnnb
鳩	jnnm
鷲	jnnn
牞	jnno
奺	jnnp
咎	jno
啾	jnob
九	jnp
久	jnpb
乆	jnpm
旧	jnr
舏	jnsm
萛	jnum
僦	jnv
乣	jnvm
倃	jnvn
救	jnw
玖	jnwb
究	jnx
慦	jnxm
就	jny
鯦	jnym
赳	jnz
蹵	jnzm
摪	jqam
摾	jqan
虹	jqc
將	jqcm
螀	jqcn
螿	jqco
奖	jqd
豇	jqdb
奨	jqdm
奬	jqdn
殭	jqdo
江	jqe
浆	jqeb
洚	jqec
漿	jqem
滰	jqen
降	jqf
匠	jqfb
缰	jqfc
绛	jqfd
絳	jqfm
匞	jqfn
繮	jqfo
强	jqg
強	jqgm
韁	jqgn
弜	jqgo
弶	jqgp
彊	jqgq
桨	jqi
槳	jqim
杢	jqin
橿	jqio
櫤	jqip
袶	jqkm
耩	jql
勥	jqlm
膙	jqln
糨	jqm
糡	jqmm
姜	jqn
犟	jqnb
将	jqp
礓	jqpb
丬	jqpc
酱	jqq
靓	jqqb
獎	jqqm
醬	jqqn
醤	jqqo
嵹	jqsm
疆	jqt
畕	jqtm
塂	jqtn
畺	jqto
壃	jqtp
疅	jqtq
蒋	jqu
茳	jqub
蔣	jqum
葁	jqun
薑	jquo
僵	jqv
傋	jqvm
讲	jqy
講	jqym
翞	jqyn
鳉	jqyo
顜	jqyp
謽	jqyq
鱂	jqyr
夅	jqzm
捐	jra
捲	jram
蠲	jrc
奆	jrdm
奍	jrdn
涓	jre
淃	jrem
绢	jrf
鄄	jrfb
絹	jrfm
絭	jrfn
縳	jrfo
弮	jrgm
鞙	jrgn
焆	jrhm
桊	jri
棬	jrim
梋	jrin
椦	jrio
卷	jrj
镌	jrjb
锩	jrjc
錈	jrjm
鐫	jrjn
帣	jrjo
巻	jrjp
鋗	jrjq
鋑	jrjr
鎸	jrjs
裐	jrkm
脧	jrlm
劵	jrln
勌	jrlo
朘	jrlp
腃	jrlq
勬	jrlr
臇	jrls
眷	jrm
睊	jrmm
睠	jrmn
闂	jrmo
娟	jrn
鹃	jrnb
鵑	jrnm
姢	jrnn
婘	jrno
呟	jrom
狷	jrq
獧	jrqm
罥	jrsm
飬	jrsn
嶲	jrso
餋	jrsp
羂	jrsq
巂	jrsr
埍	jrtm
菤	jrum
蔨	jrun
倦	jrv
圈	jrw
瓹	jrwm
圏	jrwn
悁	jrxm
惓	jrxn
慻	jrxo
讂	jrym
隽	jrz
雋	jrzm
踡	jrzn
臦	jscm
臩	jscn
泂	jsem
浻	jsen
澃	jseo
絅	jsfm
綗	jsfn
炯	jsh
炅	jshb
扃	jshc
扄	jshm
烱	jshn
煚	jsho
煛	jshp
熲	jshq
燛	jshr
銄	jsjm
褧	jskm
駉	jsmm
駫	jsmn
昋	jsrm
冂	jst
坰	jstm
冋	jstn
冏	jsto
埛	jstp
蘏	jsum
蘔	jsun
侰	jsvm
僒	jsvn
囧	jswm
窘	jsx
颎	jsym
顈	jsyn
迥	jsz
逈	jszm
接	jta
捷	jtab
揭	jtac
拮	jtad
扢	jtam
掲	jtan
掶	jtao
搩	jtap
擑	jtaq
擳	jtar
擮	jtas
皆	jtb
疥	jtbb
疖	jtbc
家	jtbd
癤	jtbm
痎	jtbn
街	jtc
蚧	jtcb
徣	jtcm
蛣	jtcn
蜐	jtco
蛶	jtcp
蝍	jtcq
镼	jtcr
蝔	jtcs
蠞	jtct
蠘	jtcu
蠽	jtcv
刦	jtdm
刧	jtdn
刼	jtdo
洁	jte
潔	jtem
洯	jten
湝	jteo
滐	jtep
结	jtf
阶	jtfb
階	jtfm
結	jtfn
斺	jtfo
紒	jtfp
絜	jtfq
戒	jtg
截	jtgb
骱	jtgc
庎	jtgm
鞂	jtgn
鞊	jtgo
秸	jth
稭	jthm
煯	jthn
杰	jti
桀	jtib
楷	jtic
桔	jtid
杢	jtim
桝	jtin
椄	jtio
楬	jtip
楐	jtiq
楶	jtir
榤	jtis
檞	jtit
解	jtj
卩	jtjb
卪	jtjm
鉣	jtjn
觧	jtjo
幯	jtjp
鍻	jtjq
鎅	jtjr
節	jtkm
衱	jtkn
衸	jtko
袓	jtkp
袺	jtkq
裓	jtkr
褯	jtks
劫	jtl
竭	jtlb
丯	jtlm
劼	jtln
脻	jtlo
耤	jtlp
睫	jtm
阂	jtmb
毑	jtmm
姐	jtn
婕	jtnb
妎	jtnm
媎	jtnn
媘	jtno
媫	jtnp
嫅	jtnq
犗	jtnr
鶛	jtns
鶡	jtnt
嗟	jto
喈	jtob
嚌	jtom
吤	jton
唶	jtoo
啑	jtop
喼	jtoq
届	jtp
碣	jtpb
屆	jtpm
砎	jtpn
礍	jtpo
狤	jtqm
昅	jtrm
曁	jtrn
岕	jtsm
岊	jtsn
崨	jtso
嵑	jtsp
嵥	jtsq
飷	jtsr
嶱	jtss
嶰	jtst
嶻	jtsu
巀	jtsv
界	jtt
畍	jttm
堦	jttn
堺	jtto
节	jtu
藉	jtub
芥	jtuc
莭	jtum
菨	jtun
蓵	jtuo
借	jtv
介	jtvb
偈	jtvc
价	jtvd
傑	jtvm
價	jtvn
倢	jtvo
偼	jtvp
玠	jtwm
瑎	jtwn
琾	jtwo
尐	jtxm
悈	jtxn
诫	jty
颉	jtyb
羯	jtyc
诘	jtyd
讦	jtye
鲒	jtyf
誡	jtym
訐	jtyn
詰	jtyo
頡	jtyp
鮚	jtyq
魪	jtyr
誱	jtys
謯	jtyt
孑	jtz
疌	jtzm
迼	jtzn
趌	jtzo
跲	jtzp
踕	jtzq
据	jua
拒	juab
拘	juac
掬	juad
據	juam
抅	juan
拠	juao
捄	juap
挶	juaq
挙	juar
揟	juas
擧	juat
具	jub
疽	jubb
匊	jubm
痀	jubn
寠	jubo
车	juc
龃	jucb
車	jucm
齟	jucn
蚷	juco
輂	jucp
蜛	jucq
螶	jucr
忂	jucs
举	jud
剧	judb
劇	judm
沮	jue
洰	juem
泃	juen
泦	jueo
淗	juep
涺	jueq
湨	juer
澽	jues
巨	juf
聚	jufb
飓	jufc
颶	jufm
巪	jufn
邭	jufo
陱	jufp
郹	jufq
聥	jufr
繘	jufs
鞠	jug
鞫	jugb
弆	jugm
且	juh
炬	juhb
秬	juhm
焗	juhn
焣	juho
虡	juhp
橘	jui
桔	juib
榉	juic
柜	juid
枸	juie
椐	juif
榘	juig
櫸	juim
櫃	juin
梮	juio
椇	juip
椈	juiq
檋	juir
欅	juis
锯	juj
钜	jujb
锔	jujc
舉	jujm
鋸	jujn
鉅	jujo
鋦	jujp
凥	jujq
鐻	jujr
裾	juk
袓	jukm
筥	jukn
簴	juko
籧	jukp
襷	jukq
耟	julm
腒	juln
勮	julo
驹	jum
駒	jumm
眗	jumn
毩	jumo
粔	jump
毱	jumq
駏	jumr
閰	jums
粷	jumt
駶	jumu
驧	jumv
犋	jun
姖	junm
娵	junn
婅	juno
婮	junp
犑	junq
鴡	junr
鵙	juns
鵴	junt
鶋	junu
鶪	junv
句	juo
咀	juob
啹	juom
局	jup
居	jupb
屦	jupc
屨	jupm
砠	jupn
狙	juq
醵	juqb
狊	juqm
昛	jurm
矩	jus
岠	jusm
岨	jusn
罝	juso
崌	jusp
豦	jusq
躹	jusr
巈	juss
鼰	just
鼳	jusu
埧	jutm
埾	jutn
壉	juto
菊	juu
莒	juub
苴	juuc
苣	juud
蒩	juum
蒟	juun
蓻	juuo
蘜	juup
俱	juv
倨	juvb
乬	juvm
伡	juvn
俥	juvo
侷	juvp
倶	juvq
僪	juvr
琚	juw
珇	juwm
惧	jux
窭	juxb
懼	juxm
窶	juxn
怇	juxo
怚	juxp
怐	juxq
愳	juxr
懅	juxs
讵	juy
詎	juym
鮔	juyn
諊	juyo
鮈	juyp
距	juz
踞	juzb
趄	juzc
遽	juzd
踽	juze
雎	juzf
歫	juzm
跙	juzn
跔	juzo
跼	juzp
艍	juzq
趜	juzr
踘	juzs
貗	juzt
蹫	juzu
躆	juzv
侷	jvvm
挾	jwam
扴	jwan
抸	jwao
拁	jwap
擖	jwaq
家	jwb
贾	jwbb
痂	jwbc
瘕	jwbd
賈	jwbm
宊	jwbn
蛱	jwc
蛺	jwcm
徍	jwcn
徦	jwco
夹	jwd
夾	jwdm
斚	jwdn
斝	jwdo
浃	jwe
浹	jwem
泇	jwen
郏	jwf
郟	jwfm
纐	jwfn
戛	jwg
戞	jwgm
稼	jwh
架	jwi
枷	jwib
梜	jwim
椵	jwin
槚	jwio
榎	jwip
榢	jwiq
檟	jwir
钾	jwj
铗	jwjb
镓	jwjc
鉀	jwjm
鋏	jwjn
鎵	jwjo
幏	jwjp
鉫	jwjq
袈	jwk
笳	jwkb
裌	jwkm
筴	jwkn
加	jwl
胛	jwlb
耞	jwlm
脥	jwln
腵	jwlo
麚	jwlp
驾	jwm
駕	jwmm
毠	jwmn
糘	jwmo
嫁	jwn
婽	jwnm
犌	jwnn
鴐	jwno
鴶	jwnp
鵊	jwnq
嘉	jwo
嘏	jwob
唊	jwom
嗧	jwon
猰	jwqm
猳	jwqn
岬	jws
豭	jwsm
甲	jwt
圿	jwtm
埉	jwtn
茄	jwu
葭	jwub
荚	jwuc
莢	jwum
价	jwv
假	jwvb
佳	jwvc
伽	jwvd
價	jwvm
乫	jwvn
傢	jwvo
珈	jww
玾	jwwm
恝	jwx
忦	jwxm
颊	jwy
頰	jwym
頡	jwyn
叚	jwyo
頬	jwyp
迦	jwz
跏	jwzb
跲	jwzm
貑	jwzn
搢	jxam
赆	jxb
贐	jxbm
寖	jxbn
凚	jxbo
賮	jxbp
厪	jxcm
齽	jxcn
殣	jxdm
津	jxe
浸	jxeb
兓	jxem
浕	jxen
溍	jxeo
漌	jxep
濅	jxeq
濜	jxer
紧	jxf
缙	jxfb
緊	jxfm
縉	jxfn
紟	jxfo
靳	jxg
廑	jxgb
烬	jxh
燼	jxhm
煡	jxhn
黅	jxho
槿	jxi
枃	jxim
榗	jxin
金	jxj
锦	jxjb
巾	jxjc
斤	jxjd
觐	jxje
卺	jxjf
钅	jxjg
錦	jxjm
巹	jxjn
覲	jxjo
釒	jxjp
觔	jxjq
釿	jxjr
筋	jxk
襟	jxkb
衿	jxkc
竻	jxkm
笒	jxkn
劲	jxl
勁	jxlm
劤	jxln
鹶	jxlo
矜	jxm
盡	jxmm
矝	jxmn
馸	jxmo
妗	jxn
婜	jxnm
嫤	jxnn
嬐	jxno
嬧	jxnp
噤	jxo
唫	jxom
嚍	jxon
尽	jxp
砛	jxpm
歏	jxqm
晋	jxr
晉	jxrm
禁	jxs
馑	jxsb
饉	jxsm
祲	jxsn
堇	jxt
埐	jxtm
堻	jxtn
墐	jxto
壗	jxtp
荩	jxu
藎	jxum
荕	jxun
菫	jxuo
菳	jxup
蓳	jxuq
今	jxv
仅	jxvb
僅	jxvm
仐	jxvn
伒	jxvo
侭	jxvp
僸	jxvq
儘	jxvr
瑾	jxw
珒	jxwm
琎	jxwn
琻	jxwo
瑨	jxwp
璡	jxwq
璶	jxwr
惍	jxxm
慬	jxxn
谨	jxy
謹	jxym
进	jxz
近	jxzb
進	jxzm
臸	jxzn
擏	jyam
净	jyb
痉	jybb
凈	jybm
痙	jybn
宑	jybo
径	jyc
徑	jycm
巠	jycn
蟼	jyco
荆	jyd
刭	jydb
剄	jydm
丼	jydn
殑	jydo
殌	jydp
泾	jye
涇	jyem
汫	jyen
汬	jyeo
浄	jyep
淨	jyeq
澋	jyer
瀞	jyes
经	jyf
阱	jyfb
旌	jyfc
經	jyfm
旍	jyfn
経	jyfo
聙	jyfp
綡	jyfq
弪	jyg
弳	jygm
井	jyh
秔	jyhm
稉	jyhn
桱	jyim
梷	jyin
橸	jyio
镜	jyj
鏡	jyjm
幜	jyjn
鋞	jyjo
兢	jyk
箐	jykb
竟	jyl
劲	jylb
竞	jylc
靖	jyld
胫	jyle
肼	jylf
腈	jylg
勁	jylm
競	jyln
脛	jylo
劤	jylp
竫	jylq
竧	jylr
麖	jyls
竸	jylt
麠	jylu
精	jym
睛	jymb
粳	jymc
驚	jymm
粇	jymn
婧	jyn
妌	jynm
婙	jynn
婛	jyno
鵛	jynp
鶄	jynq
鶁	jynr
静	jyq
靓	jyqb
獍	jyqc
靜	jyqm
靚	jyqn
獷	jyqo
猄	jyqp
景	jyr
晶	jyrb
曔	jyrm
暻	jyrn
鼱	jysm
京	jyt
境	jytb
坓	jytm
坙	jytn
坕	jyto
亰	jytp
菁	jyu
茎	jyub
荊	jyum
莖	jyun
葏	jyuo
儆	jyv
俓	jyvm
倞	jyvn
傹	jyvo
敬	jyw
璄	jywm
璥	jywn
璟	jywo
惊	jyx
憬	jyxb
穽	jyxm
憼	jyxn
警	jyy
颈	jyyb
鲸	jyyc
頸	jyym
鯨	jyyn
誩	jyyo
頚	jyyp
迳	jyz
逕	jyzm
踁	jyzn
繫	jzfz
鏶	jzjo
鐖	jzjp
鑇	jzjq
鑙	jzjr
鏩	jzjt
鐗	jzju
鐱	jzjv
鑑	jzjw
鑬	jzjx
鑯	jzjy
鑳	jzjz
諆	jzys
諔	jzyt
鮆	jzyu
鯚	jzyv
譤	jzyw
鱀	jzyx
鰿	jzyy
鰶	jzyz
擖	kaam
桛	kaim
鉲	kajm
裃	kakm
卡	kal
胩	kalb
咖	kao
喀	kaob
咯	kaoc
咔	kaod
垰	katm
佧	kav
鰿	kaym
拷	kca
洘	kcem
靠	kcf
髛	kcgm
烤	kch
丂	kchm
焅	kchn
熇	kcho
稾	kchp
栲	kci
铐	kcj
銬	kcjm
考	kcl
犒	kcn
尻	kcp
嵪	kcsm
薧	kcum
佧	kcv
攷	kcwm
鲓	kcym
鮳	kcyn
揩	kda
輆	kdcm
剀	kdd
豈	kddm
剴	kddn
奒	kddo
濭	kdem
颽	kdfm
开	kdg
炌	kdhm
烗	kdhn
楷	kdi
凯	kdj
铠	kdjb
锴	kdjc
锎	kdjd
凱	kdjm
鍇	kdjn
鎧	kdjo
鐦	kdjp
鎎	kdjq
勓	kdlm
開	kdmm
闿	kdmn
闓	kdmo
嘅	kdom
欯	kdqm
欬	kdqn
暟	kdrm
嵦	kdsm
垲	kdt
塏	kdtm
蒈	kdu
慨	kdx
恺	kdxb
忾	kdxc
愷	kdxm
愒	kdxn
鯌	kdym
揢	keam
搕	kean
客	keb
疴	kebb
痾	kebm
轲	kec
蝌	kecb
蚵	kecc
軻	kecm
尅	kecn
刻	ked
剋	kedm
渴	kee
溘	keeb
渇	keem
濭	keen
缂	kef
緙	kefm
匼	kefn
髁	keg
科	keh
稞	kehb
炣	kehm
棵	kei
柯	keib
榼	keim
樖	kein
钶	kej
锞	kejb
鈳	kejm
鉿	kejn
錒	kejo
錁	kejp
袔	kekm
龕	kelm
勀	keln
勊	kelo
瞌	kem
骒	kemb
騾	kemm
騍	kemn
閜	kemo
毼	kemp
牱	kenm
娔	kenn
犐	keno
可	keo
咳	keob
嗑	keoc
磕	kep
殼	kepm
牁	kepn
砢	kepo
殻	kepp
硞	kepq
磆	kepr
碦	keps
礊	kept
礚	kepu
氪	keq
欬	keqm
歁	keqn
醘	keqo
克	kes
壳	kesb
岢	kesc
峇	kesm
嵑	kesn
嵙	keso
嶱	kesp
坷	ket
堁	ketm
苛	keu
萪	keum
薖	keun
珂	kew
敤	kewm
恪	kex
窠	kexb
愾	kexm
悈	kexn
衉	kexo
愘	kexp
愙	kexq
窼	kexr
课	key
颗	keyb
颏	keyc
課	keym
顆	keyn
頦	keyo
翗	keyp
趷	kezm
扣	kfa
抠	kfab
摳	kfam
寇	kfb
宼	kfbm
剾	kfdm
滱	kfem
彄	kfgm
釦	kfjm
筘	kfk
簆	kfkm
劶	kflm
竘	kfln
眍	kfm
瞘	kfmm
眗	kfmn
冦	kfmo
瞉	kfmp
鷇	kfnm
口	kfo
叩	kfob
蔻	kfu
芤	kfub
蔲	kfum
敂	kfwm
怐	kfxm
艐	kfzm
掯	kgam
龈	kgc
齦	kgcm
龂	kgcn
齗	kgco
錹	kgjm
裉	kgk
褃	kgkm
肯	kgl
肎	kglm
肻	kgln
啃	kgo
硍	kgpm
豤	kgsm
垦	kgt
墾	kgtm
珢	kgwm
恳	kgx
懇	kgxm
窛	kgxn
抗	kha
扛	khab
摃	kham
漮	khem
匟	khfm
邟	khfn
康	khg
炕	khh
穅	khhm
槺	khim
钪	khj
鈧	khjm
鏮	khjn
糠	khm
闶	khmb
閌	khmm
粇	khmn
嫝	khnm
砊	khpm
犺	khqm
嵻	khsm
躿	khsn
亢	kht
伉	khv
囥	khwm
慷	khx
忼	khxm
鱇	khym
貇	khzm
捆	kka
髡	kkb
髠	kkbm
髨	kkbn
蜫	kkcm
涃	kkem
潉	kken
綑	kkfm
稇	kkhm
焜	kkhn
稛	kkho
熴	kkhp
梱	kkim
锟	kkj
錕	kkjm
裈	kkkm
裍	kkkn
裩	kkko
褌	kkkp
臗	kklm
阃	kkm
閫	kkmm
睏	kkmn
閸	kkmo
騉	kkmp
婫	kknm
鹍	kknn
鵾	kkno
鶤	kknp
硱	kkpm
醌	kkq
猑	kkqm
昆	kkr
晜	kkrm
壸	kksm
崐	kksn
崑	kkso
祵	kksp
壼	kksq
豤	kksr
坤	kkt
堒	kktm
堃	kktn
菎	kkum
困	kkw
琨	kkwb
瑻	kkwm
悃	kkx
鲲	kky
鯤	kkym
鰥	kkyn
鱇	kkyo
扻	klam
衎	klcm
輡	klcn
轗	klco
刊	kld
鬫	kldm
戡	klg
槛	kli
檻	klim
栞	klin
凵	klk
勘	kll
龛	kllb
龕	kllm
竷	klln
看	klm
瞰	klmb
阚	klmc
闞	klmm
冚	klmn
矙	klmo
砍	klp
丬	klpb
磡	klpm
欿	klqm
歁	klqn
嵌	kls
崁	klsm
嵁	klsn
堪	klt
坎	kltb
埳	kltm
墈	kltn
莰	klu
侃	klv
偘	klvm
惂	klxm
顑	klym
貇	klzm
括	koa
扩	koab
擴	koam
拡	koan
挄	koao
髺	kobm
鬠	kobn
蛞	koc
漷	koem
濶	koen
廓	kog
鞟	kogm
鞹	kogn
秮	kohm
秳	kohn
铦	kojm
銛	kojn
銽	kojo
筈	kokm
阔	kom
闊	komm
噋	koom
霩	korm
葀	koum
萿	koun
韕	kowm
懖	koxm
顑	koym
适	koz
尅	kpcm
剋	kpdm
勀	kplm
頢	kpym
抂	kqam
况	kqb
贶	kqbb
貺	kqbm
卝	kqbn
軖	kqcm
軠	kqcn
軦	kqco
軭	kqcp
夼	kqd
剋	kqdm
況	kqem
洭	kqen
匡	kqf
邝	kqfb
纩	kqfc
鄺	kqfm
纊	kqfn
邼	kqfo
匩	kqfp
絋	kqfq
絖	kqfr
黋	kqhm
爌	kqhn
穬	kqho
框	kqi
鉱	kqjm
鋛	kqjn
鑛	kqjo
筐	kqk
筺	kqkm
丱	kqlm
劻	kqln
眶	kqm
眖	kqmm
矌	kqmn
鵟	kqnm
哐	kqo
矿	kqp
礦	kqpm
砿	kqpn
硄	kqpo
狂	kqq
狅	kqqm
旷	kqr
曠	kqrm
昿	kqrn
岲	kqsm
圹	kqt
壙	kqtm
儣	kqvm
忹	kqxm
恇	kqxn
懭	kqxo
懬	kqxp
诳	kqy
诓	kqyb
誆	kqym
誑	kqyn
宽	krb
寬	krbm
寛	krbn
髋	krg
髖	krgm
梡	krim
鑧	krjm
臗	krlm
款	krq
欵	krqm
歀	krqn
窽	krxm
窾	krxn
迋	krzm
控	ksa
涳	ksem
鞚	ksgm
椌	ksim
錓	ksjm
箜	ksk
鵼	ksnm
矼	kspm
硿	kspn
崆	kss
躻	kssm
埪	kstm
倥	ksv
空	ksx
恐	ksxb
悾	ksxm
窾	ksxn
羫	ksym
孔	ksz
扝	kuam
捁	kuan
搰	kuao
瘔	kubm
刳	kud
绔	kuf
絝	kufm
郀	kufn
库	kug
骷	kugb
庫	kugm
廤	kugn
秙	kuhm
焅	kuhn
枯	kui
桍	kuim
楛	kuin
裤	kuk
褲	kukm
袴	kukn
朏	kulm
胐	kuln
哭	kuo
喾	kuob
嚳	kuom
矻	kupm
硞	kupn
酷	kuq
狜	kuqm
堀	kut
苦	kuu
俈	kuvm
圐	kuwm
窟	kux
窋	kuxm
鮬	kuym
跍	kuzm
揆	kva
勹	kvb
蝰	kvc
奎	kvd
刲	kvdm
殨	kvdn
溃	kve
潰	kvem
匮	kvf
聩	kvfb
隗	kvfc
匱	kvfm
聵	kvfn
鄈	kvfo
聭	kvfp
聧	kvfq
魁	kvg
戣	kvgm
亏	kvh
虧	kvhm
煃	kvhn
楏	kvim
楑	kvin
樻	kvio
櫆	kvip
卼	kvjm
鍷	kvjn
鍨	kvjo
鐀	kvjp
篑	kvk
簣	kvkm
籄	kvkn
胿	kvlm
膭	kvln
盔	kvm
睽	kvmb
骙	kvmm
瞆	kvmn
瞶	kvmo
騤	kvmp
闚	kvmq
媿	kvnm
嬇	kvnn
犪	kvno
喹	kvo
喟	kvob
嘳	kvom
磈	kvpm
欳	kvqm
暌	kvr
晆	kvrm
馈	kvs
馗	kvsb
岿	kvsc
饋	kvsm
巋	kvsn
餽	kvso
巙	kvsp
葵	kvu
蒉	kvub
蕢	kvum
藈	kvun
蘷	kvuo
蘬	kvup
虁	kvuq
傀	kvv
愧	kvx
窥	kvxb
愦	kvxc
悝	kvxd
窺	kvxm
憒	kvxn
鮭	kvym
尯	kvyn
頄	kvyo
頍	kvyp
頯	kvyq
謉	kvyr
顝	kvys
逵	kvz
夔	kvzb
跬	kvzc
歸	kvzm
跍	kvzn
蹞	kvzo
躨	kvzp
挎	kwa
夸	kwd
絓	kwfm
骻	kwgm
楇	kwim
錁	kwjm
銙	kwjn
胯	kwl
姱	kwnm
咵	kwom
晇	kwrm
垮	kwt
侉	kwv
恗	kwxm
誇	kwym
跨	kwz
趶	kwzm
舿	kwzn
躨	kwzo
擓	kyam
浍	kycm
巜	kye
澮	kyem
郐	kyf
鄶	kyfm
旝	kyfn
廥	kygm
筷	kyk
凷	kykm
脍	kyl
膾	kylm
駃	kymm
糩	kymn
哙	kyo
噲	kyom
狯	kyq
獪	kyqm
欳	kyqn
會	kyrm
块	kyt
塊	kytm
圦	kytn
墤	kyto
蒯	kyu
蕢	kyum
会	kyv
侩	kyvb
儈	kyvm
璯	kywm
快	kyx
鲙	kyym
鱠	kyyn
舿	kyzm
挳	kzam
揁	kzan
摼	kzao
阬	kzfm
铿	kzj
鏗	kzjm
銵	kzjn
鍞	kzjo
脛	kzlm
劥	kzln
妔	kznm
牼	kznn
吭	kzo
硁	kzpm
殸	kzpn
硜	kzpo
硻	kzpp
坑	kzt
坈	kztm
誙	kzym
鱠	kzyn
拉	laa
揦	laam
搚	laan
揧	laao
擸	laap
攋	laaq
瘌	lab
癩	labm
鬎	labn
蜡	lac
蠟	lacm
蝋	lacn
蝲	laco
剌	lad
溂	laem
鞡	lagm
爉	lahm
柆	laim
楋	lain
櫴	laio
镴	lajm
鑞	lajn
腊	lal
臘	lalm
臈	laln
啦	lao
喇	laob
嚹	laom
砬	lap
磖	lapm
旯	lar
垃	lat
落	lau
菈	laum
藞	laun
瓎	lawm
辣	lax
辢	laxm
翋	laym
誙	layn
鯻	layo
邋	laz
捞	lca
撈	lcam
痨	lcb
癆	lcbm
蛯	lccm
蟧	lccn
轑	lcco
潦	lce
涝	lceb
澇	lcem
浶	lcen
络	lcf
絡	lcfm
髝	lcgm
烙	lch
栳	lci
橑	lcim
橯	lcin
铑	lcj
铹	lcjb
銠	lcjm
鐒	lcjn
簩	lckm
老	lcl
劳	lclb
耢	lclc
勞	lclm
耮	lcln
耂	lclo
労	lclp
朥	lclq
閖	lcmm
粩	lcmn
牢	lcn
姥	lcnb
嫪	lcnm
唠	lco
嘮	lcom
咾	lcon
哰	lcoo
嗠	lcop
硓	lcpm
磱	lcpn
酪	lcq
醪	lcqb
狫	lcqm
崂	lcs
嶗	lcsm
躼	lcsn
軂	lcso
落	lcu
荖	lcum
佬	lcv
僗	lcvm
珯	lcwm
忉	lcx
恅	lcxm
窂	lcxn
憦	lcxo
憥	lcxp
鮱	lcym
顟	lcyn
鱩	lcyo
邋	lcz
攋	ldam
赖	ldb
癞	ldbb
赉	ldbc
賴	ldbm
賚	ldbn
賫	ldbo
癘	ldbp
癩	ldbq
徕	ldc
徠	ldcm
濑	lde
涞	ldeb
淶	ldem
瀨	lden
瀬	ldeo
郲	ldfm
庲	ldgm
来	ldi
梾	ldim
棶	ldin
櫴	ldio
铼	ldj
錸	ldjm
籁	ldk
籟	ldkm
筙	ldkn
箂	ldko
襰	ldkp
勑	ldlm
睐	ldm
睞	ldmm
騋	ldmn
麳	ldmo
娕	ldnm
婡	ldnn
鵣	ldno
鶆	ldnp
唻	ldom
猍	ldqm
崃	lds
崍	ldsm
莱	ldu
萊	ldum
藾	ldun
來	ldvm
俫	ldvn
倈	ldvo
琜	ldwm
誺	ldym
頼	ldyn
顂	ldyo
鯠	ldyp
顟	ldyq
扐	leam
泐	lee
氻	leem
阞	lefm
樂	leim
楽	lein
竻	lekm
簕	lekn
勒	lel
肋	lelb
牞	lenm
叻	leo
乐	lep
砳	lepm
饹	lesm
餎	lesn
艻	leum
了	lev
仂	levb
玏	lewm
忇	lexm
鳓	ley
鰳	leym
鱳	leyn
逨	lezm
搂	lfa
摟	lfam
瘘	lfb
瘺	lfbm
寠	lfbn
瘻	lfbo
蝼	lfc
螻	lfcm
漏	lfe
溇	lfem
漊	lfen
陋	lff
髅	lfg
髏	lfgm
廔	lfgn
鞻	lfgo
熡	lfhm
楼	lfi
樓	lfim
镂	lfj
鏤	lfjm
篓	lfk
簍	lfkm
耧	lfl
耬	lflm
瞜	lfmm
娄	lfn
婁	lfnm
鷜	lfnn
喽	lfo
嘍	lfom
屚	lfpm
露	lfr
嵝	lfs
嶁	lfsm
軁	lfsn
塿	lftm
蒌	lfu
蔞	lfum
偻	lfv
僂	lfvm
甊	lfwm
窶	lfxm
慺	lfxn
韷	lfym
謱	lfyn
遱	lfzm
艛	lfzn
掠	lga
掠	lgab
寽	lgcm
稤	lghm
锊	lgj
锊	lgjb
鋝	lgjm
鋝	lgjn
鋢	lgjo
略	lgt
略	lgtb
畧	lgtm
畧	lgtn
貗	lgzm
螂	lhc
蜋	lhcm
浪	lhe
郎	lhf
郞	lhfm
郒	lhfn
廊	lhg
稂	lhh
烺	lhhm
榔	lhi
桹	lhim
樃	lhin
锒	lhj
鋃	lhjm
鎯	lhjn
筤	lhkm
朗	lhl
勆	lhlm
朖	lhln
朤	lhlo
阆	lhm
閬	lhmm
駺	lhmn
嫏	lhnm
啷	lho
哴	lhom
硠	lhpm
狼	lhq
欴	lhqm
崀	lhsm
躴	lhsn
埌	lhtm
塱	lhtn
莨	lhu
蒗	lhub
蓈	lhum
蓢	lhun
琅	lhw
瑯	lhwm
斏	lhwn
圙	lhwo
誏	lhym
羮	lhyn
扐	liam
扚	lian
搮	liao
擽	liap
攊	liaq
攦	liar
攭	lias
痢	lib
疠	libb
疬	libc
癘	libm
癧	libn
凓	libo
鬁	libp
皪	libq
历	lic
厉	licb
厘	licc
蠡	licd
蛎	lice
蜊	licf
轹	licg
厲	licm
蠣	licn
轢	lico
蚸	licp
厤	licq
蛠	licr
厯	lics
蜧	lict
蝷	licu
蟍	licv
蠇	licw
蟸	licx
蠫	licy
轣	licz
利	lid
刂	lidb
刕	lidm
剓	lidn
剺	lido
豊	lidp
劙	lidq
黎	lie
漓	lieb
沥	liec
溧	lied
澧	liee
瀝	liem
沴	lien
沵	lieo
浬	liep
浰	lieq
涖	lier
漦	lies
濿	liet
灕	lieu
郦	lif
缡	lifb
縭	lifm
酈	lifn
綟	lifo
纅	lifp
纚	lifq
鬲	lig
廲	ligm
瓥	lign
丽	lih
戾	lihb
黧	lihc
秝	lihm
爄	lihn
爏	liho
穲	lihp
李	lii
梨	liib
栗	liic
栎	liid
枥	liie
櫟	liim
櫪	liin
朸	liio
杝	liip
柂	liiq
栃	liir
栵	liis
栛	liit
梸	liiu
棙	liiv
棃	liiw
樆	liix
檪	liiy
櫔	liiz
锂	lij
鋰	lijm
鎘	lijn
鉝	lijo
銐	lijp
鋫	lijq
錅	lijr
鏫	lijs
觻	lijt
鑗	liju
篱	lik
笠	likb
篥	likc
裏	likm
籬	likn
裡	liko
筣	likp
褵	likq
里	lil
力	lilb
立	lilc
隶	lild
励	lile
膦	lilf
勵	lilm
隸	liln
麗	lilo
脷	lilp
竰	lilq
隷	lilr
釐	lils
麜	lilt
粒	lim
骊	limb
粝	limc
糲	limm
驪	limn
睙	limo
睝	limp
粴	limq
盠	limr
糎	lims
盭	limt
犁	lin
鹂	linb
嫠	linc
娌	lind
鸝	linm
娳	linn
婯	lino
犂	linp
鳨	linq
犛	linr
鴗	lins
犡	lint
鵹	linu
鷅	linv
孋	linw
哩	lio
吏	liob
唳	lioc
呖	liod
喱	lioe
嚦	liom
唎	lion
嚟	lioo
囄	liop
囇	lioq
砾	lip
砺	lipb
礫	lipm
礪	lipn
砅	lipo
磿	lipp
礰	lipq
狸	liq
猁	liqb
醴	liqc
醨	liqm
雳	lir
靂	lirm
暦	lirn
曆	liro
曞	lirp
靋	lirq
礼	lis
罹	lisb
禮	lism
屴	lisn
岦	liso
峛	lisp
峢	lisq
峲	lisr
巁	liss
禲	list
离	lit
坜	litb
壢	litm
塛	litn
莉	liu
荔	liub
藜	liuc
莅	liud
蓠	liue
苈	liuf
蒞	lium
藶	liun
蘺	liuo
苙	liup
茘	liuq
荲	liur
菞	lius
蒚	liut
蔾	liuu
例	liv
俐	livb
俪	livc
俚	livd
傈	live
儷	livm
儮	livn
理	liw
璃	liwb
珕	liwm
琍	liwn
瓼	liwo
甅	liwp
瑮	liwq
瓈	liwr
瓅	liws
斄	liwt
瓑	liwu
悧	lixm
悡	lixn
悷	lixo
慄	lixp
鲤	liy
詈	liyb
鲡	liyc
鳢	liyd
鯉	liym
鱧	liyn
鱺	liyo
叓	liyp
叕	liyq
謧	liyr
鯏	liys
鯬	liyt
讈	liyu
鱱	liyv
逦	liz
跞	lizb
貍	lizm
歷	lizn
離	lizo
邐	lizp
躒	lizq
迣	lizr
赲	lizs
艃	lizt
艆	lizu
孷	lizv
歴	lizw
邌	lizx
摙	ljam
鬑	ljbm
蠊	ljc
螊	ljcm
殓	ljd
奁	ljdb
奩	ljdm
殮	ljdn
劆	ljdo
涟	lje
潋	ljeb
濂	ljec
漣	ljem
瀲	ljen
浰	ljeo
湅	ljep
溓	ljeq
澰	ljer
濓	ljes
瀮	ljet
联	ljf
练	ljfb
練	ljfm
聯	ljfn
匲	ljfo
聨	ljfp
聫	ljfq
匳	ljfr
聮	ljfs
縺	ljft
鄻	ljfu
纞	ljfv
廉	ljg
炼	ljh
煉	ljhm
熑	ljhn
稴	ljho
燫	ljhp
楝	lji
梿	ljim
槤	ljin
槏	ljio
櫣	ljip
檶	ljiq
链	ljj
帘	ljjb
镰	ljjc
鏈	ljjm
鐮	ljjn
覝	ljjo
錬	ljjp
鍊	ljjq
鎌	ljjr
裢	ljk
裣	ljkb
簾	ljkm
褳	ljkn
襝	ljko
籢	ljkp
籨	ljkq
脸	ljl
臁	ljlb
臉	ljlm
孌	ljnm
媡	ljnn
嫾	ljno
嬚	ljnp
嗹	ljom
噒	ljon
磏	ljpm
歛	ljqm
醶	ljqn
堜	ljtm
亷	ljtn
莲	lju
蔹	ljub
蓮	ljum
薟	ljun
蘞	ljuo
萰	ljup
薕	ljuq
蘝	ljur
僆	ljvm
敛	ljw
琏	ljwb
斂	ljwm
璉	ljwn
瑓	ljwo
恋	ljx
怜	ljxb
憐	ljxm
戀	ljxn
慩	ljxo
鲢	ljy
鰱	ljym
翴	ljyn
謰	ljyo
羷	ljyp
鰊	ljyq
连	ljz
連	ljzm
赲	ljzn
蹥	ljzo
抡	lka
掄	lkam
轮	lkc
輪	lkcm
蜦	lkcn
沦	lke
淪	lkem
溣	lken
纶	lkf
綸	lkfm
陯	lkfn
稐	lkhm
棆	lkim
錀	lkjm
腀	lklm
耣	lkln
睔	lkmm
婨	lknm
碖	lkpm
磮	lkpn
崘	lksm
崙	lksn
埨	lktm
芲	lkum
菕	lkun
伦	lkv
仑	lkvb
侖	lkvm
倫	lkvn
囵	lkw
圇	lkwm
惀	lkxm
论	lky
論	lkym
鯩	lkyn
踚	lkzm
蹥	lkzn
拦	lla
揽	llab
攔	llam
攬	llan
擥	llao
兰	llb
厱	llcm
滥	lle
澜	lleb
漤	llec
濫	llem
瀾	llen
浨	lleo
灆	llep
灡	lleq
灠	ller
缆	llf
纜	llfm
繿	llfn
韊	llgm
烂	llh
爛	llhm
燗	llhn
燷	llho
燣	llhp
爁	llhq
爤	llhr
爦	llhs
栏	lli
榄	llib
欄	llim
欖	llin
欗	llio
览	llj
镧	lljb
覽	lljm
鑭	lljn
覧	lljo
幱	lljp
钄	lljr
篮	llk
褴	llkb
籃	llkm
襤	llkn
襕	llko
襴	llkp
籣	llkq
襽	llkr
阑	llm
闌	llmm
糷	llmn
婪	lln
嬾	llnm
孄	llnn
孏	llno
嚂	llom
囒	llon
囕	lloo
醂	llqm
暕	llrm
岚	lls
罱	llsb
嵐	llsm
坔	lltm
壈	lltn
壏	llto
蓝	llu
藍	llum
蘭	llun
葻	lluo
蘫	llup
儖	llvm
斓	llw
斕	llwm
璼	llwn
瓓	llwo
懒	llx
懶	llxm
惏	llxn
懢	llxo
谰	lly
讕	llym
諫	llyn
譋	llyo
顲	llyp
踚	llzm
躝	llzn
撩	lma
撂	lmab
摎	lmam
疗	lmb
寥	lmbb
寮	lmbc
療	lmbm
尦	lmbn
賿	lmbo
蟟	lmcm
蟧	lmcn
镽	lmco
轑	lmcp
料	lmd
潦	lme
漻	lmem
聊	lmf
缭	lmfb
繆	lmfm
繚	lmfn
鄝	lmfo
飂	lmfp
飉	lmfq
廖	lmg
豂	lmgm
廫	lmgn
髎	lmgo
燎	lmh
炓	lmhm
爎	lmhn
爒	lmho
樛	lmim
橑	lmin
镣	lmj
钌	lmjb
鐐	lmjm
釕	lmjn
簝	lmkm
膋	lmlm
膫	lmln
瞭	lmmm
鹩	lmn
鷯	lmnm
嫽	lmnn
嘹	lmo
屪	lmpm
獠	lmq
暸	lmrm
嵺	lmsm
嶚	lmsn
嶛	lmso
蓼	lmu
藔	lmum
了	lmv
僚	lmvb
敹	lmwm
璙	lmwn
窌	lmxm
尞	lmxn
憀	lmxo
憭	lmxp
窷	lmxq
竂	lmxr
尥	lmy
辽	lmz
遼	lmzm
蹽	lmzn
躝	lmzo
摎	lnam
瘤	lnb
癅	lnbm
蟉	lncm
刘	lnd
劉	lndm
流	lne
溜	lneb
浏	lnec
瀏	lnem
漻	lnen
澑	lneo
陆	lnf
绺	lnfb
旒	lnfc
陸	lnfm
綹	lnfn
斿	lnfo
旈	lnfp
飗	lnfq
飀	lnfr
飂	lnfs
飅	lnft
廇	lngm
鬸	lngn
熘	lnh
熮	lnhm
柳	lni
榴	lnib
栁	lnim
桞	lnin
桺	lnio
橊	lnip
橮	lniq
鎏	lnj
镏	lnjb
锍	lnjc
鋶	lnjm
鎦	lnjn
镠	lnjo
鏐	lnjp
鐂	lnjq
裗	lnkm
麍	lnlm
骝	lnm
騮	lnmm
駠	lnmn
駵	lnmo
驑	lnmp
鹨	lnn
鷚	lnnm
媹	lnnn
鹠	lnno
嬼	lnnp
鶹	lnnq
嚠	lnom
硫	lnp
碌	lnpb
磂	lnpm
磟	lnpn
霤	lnrm
馏	lns
餾	lnsm
嵧	lnsn
罶	lnso
六	lnt
留	lntb
畄	lntm
畱	lntn
塯	lnto
疁	lntp
羀	lntq
蒥	lnum
蓅	lnun
藰	lnuo
琉	lnw
珋	lnwm
瑠	lnwn
瑬	lnwo
璢	lnwp
窌	lnxm
懰	lnxn
翏	lnym
鰡	lnyn
遛	lnz
蹓	lnzm
蹘	lnzn
雡	lnzo
捋	loa
摞	loab
捰	loam
擽	loan
攊	loao
攎	loap
攞	loaq
攭	loar
瘰	lob
皪	lobm
癳	lobn
螺	loc
蠃	locb
寽	locm
蛒	locn
剆	lodm
洛	loe
漯	loeb
泺	loec
濼	loem
洜	loen
渃	loeo
络	lof
絡	lofm
纙	lofn
烙	loh
椤	loi
欏	loim
欙	loin
锣	loj
镙	lojb
鑼	lojm
鏍	lojn
覶	lojo
覼	lojp
裸	lok
箩	lokb
籮	lokm
笿	lokn
脶	lol
腡	lolm
臝	loln
骆	lom
骡	lomb
駱	lomm
騾	lomn
驘	lomo
犖	lonm
鵅	lonn
鸁	lono
咯	loo
啰	loom
囉	loon
囖	looo
硌	lop
礫	lopm
砢	lopn
硦	lopo
磱	lopp
猡	loq
猓	loqb
玀	loqm
曪	lorm
罗	los
羅	losm
峈	losn
躶	loso
饠	losp
落	lou
萝	loub
荦	louc
蘿	loum
茖	loun
蓏	louo
倮	lov
儸	lovm
儽	lovn
珞	low
詻	loym
頱	loyn
鮥	loyo
鱳	loyp
逻	loz
雒	lozb
跞	lozc
邏	lozm
躒	lozn
雡	lozo
擂	lpa
攂	lpam
瘣	lpbm
癗	lpbn
蠝	lpcm
轠	lpcn
泪	lpe
淚	lpem
洡	lpen
涙	lpeo
灅	lpep
累	lpf
缧	lpfb
縲	lpfm
郲	lpfn
絫	lpfo
罍	lpfp
纍	lpfq
纇	lpfr
纝	lpfs
檑	lpi
樏	lpim
櫑	lpin
櫐	lpio
欙	lpip
镭	lpj
鐳	lpjm
銇	lpjn
錑	lpjo
鑘	lpjp
鑸	lpjq
勒	lpl
肋	lplb
耒	lplc
羸	lpld
类	lpm
矋	lpmm
嫘	lpn
鸓	lpnm
嘞	lpo
磊	lpp
磥	lppm
礌	lppn
礧	lppo
礨	lppp
酹	lpq
雷	lpr
靁	lprm
厽	lpsm
祱	lpsn
禷	lpso
鼺	lpsp
垒	lpt
壘	lptm
塁	lptn
畾	lpto
壨	lptp
蕾	lpu
蔂	lpum
蕌	lpun
藟	lpuo
蘲	lpup
蘽	lpuq
蘱	lpur
虆	lpus
儡	lpv
傫	lpvm
儽	lpvn
瓃	lpwm
诔	lpy
類	lpym
誄	lpyn
頛	lpyo
頪	lpyp
讄	lpyq
邏	lpzm
掚	lqam
凉	lqb
辆	lqc
輛	lqcm
辌	lqcn
輌	lqco
蜋	lqcp
蜽	lqcq
輬	lqcr
涼	lqem
湸	lqen
緉	lqfm
綡	lqfn
良	lqg
魉	lqgb
魎	lqgm
两	lqh
兩	lqhm
両	lqhn
梁	lqi
椋	lqib
樑	lqim
锒	lqj
鍄	lqjm
裲	lqkm
簗	lqkn
量	lql
脼	lqlm
粮	lqm
粱	lqmb
糧	lqmm
駺	lqmn
唡	lqom
哴	lqon
啢	lqoo
喨	lqop
靓	lqq
靚	lqqm
晾	lqr
亮	lqt
墚	lqtb
莨	lqu
俩	lqv
倆	lqvm
俍	lqvn
倞	lqvo
悢	lqxm
谅	lqy
諒	lqym
颣	lqyn
踉	lqz
挛	lra
攣	lram
癴	lrbm
癵	lrbn
奱	lrdm
滦	lre
灤	lrem
灓	lren
栾	lri
欒	lrim
卵	lrj
銮	lrjb
鑾	lrjm
釠	lrjn
覶	lrjo
脟	lrlm
鸾	lrn
娈	lrnb
孌	lrnm
鸞	lrnn
鵉	lrno
脔	lrr
臠	lrrm
曫	lrrn
臡	lrro
峦	lrs
巒	lrsm
羉	lrsn
薍	lrum
虊	lrun
乱	lrv
亂	lrvm
乿	lrvn
圝	lrwm
圞	lrwn
孪	lrz
踉	lrzb
孿	lrzm
拢	lsa
攏	lsam
癃	lsb
贚	lsbm
衖	lscm
徿	lscn
蠬	lsco
蠪	lscp
泷	lse
瀧	lsem
湰	lsen
滝	lseo
漋	lsep
隆	lsf
聋	lsfb
陇	lsfc
隴	lsfm
聾	lsfn
弄	lsg
谾	lsgm
豅	lsgn
爖	lshm
栊	lsi
櫳	lsim
梇	lsin
槞	lsio
鏧	lsjm
鑨	lsjn
笼	lsk
籠	lskm
篢	lskn
篭	lsko
襱	lskp
龙	lsl
胧	lslb
龍	lslm
朧	lsln
竜	lslo
龒	lslp
龓	lslq
眬	lsmm
矓	lsmn
驡	lsmo
鸗	lsnm
咙	lso
嚨	lsom
哢	lson
砻	lsp
礱	lspm
硦	lspn
礲	lspo
昽	lsrm
霳	lsrn
曨	lsro
靇	lsrp
屸	lssm
嶐	lssn
巃	lsso
巄	lssp
垄	lst
垅	lstb
壟	lstm
壠	lstn
茏	lsu
蘢	lsum
儱	lsvm
珑	lsw
瓏	lswm
窿	lsx
竉	lsxm
尨	lsym
孿	lszm
躘	lszn
捩	lta
挒	ltam
挘	ltan
擸	ltao
冽	ltb
鬣	ltbb
鬛	ltbm
蛚	ltcm
巤	ltcn
列	ltd
洌	lte
浖	ltem
聗	ltfm
綟	ltfn
颲	ltfo
烈	lth
烮	lthm
煭	lthn
燤	ltho
爄	lthp
爉	lthq
栵	ltim
棙	ltin
櫑	ltio
裂	ltk
劣	ltl
劦	ltlm
劽	ltln
脟	ltlo
毟	ltmm
睙	ltmn
姴	ltnm
鴷	ltnn
犣	ltno
咧	lto
哷	ltom
猎	ltq
獵	ltqm
猟	ltqn
獦	ltqo
巁	ltsm
埒	ltt
埓	lttm
茢	ltum
儠	ltvm
忚	ltxm
鮤	ltym
鱲	ltyn
趔	ltz
躐	ltzb
迾	ltzm
躘	ltzn
掳	lua
撸	luab
擄	luam
擼	luan
挔	luao
摝	luap
攎	luaq
卢	lub
卤	lubb
赂	lubc
賂	lubm
辘	luc
辂	lucb
轳	lucc
輅	lucm
轆	lucn
轤	luco
螰	lucp
蠦	lucq
剹	ludm
泸	lue
漉	lueb
潞	luec
渌	lued
濾	luem
淥	luen
瀘	lueo
淕	luep
滷	lueq
漊	luer
澛	lues
瀂	luet
陆	luf
绿	lufb
陸	lufm
緑	lufn
罏	lufo
纑	lufp
庐	lug
戮	lugb
廬	lugm
廘	lugn
髗	lugo
炉	luh
虏	luhb
虜	luhm
爐	luhn
穭	luho
稑	luhp
熝	luhq
穋	luhr
穞	luhs
黸	luht
橹	lui
栌	luib
櫓	luim
櫨	luin
枦	luio
椂	luip
樐	luiq
樚	luir
镥	luj
錄	lujm
鑥	lujn
鈩	lujo
錴	lujp
録	lujq
鏀	lujr
鏕	lujs
鐪	lujt
鏴	luju
觻	lujv
鑪	lujw
簏	luk
箓	lukm
簶	lukn
簵	luko
簬	lukp
籚	lukq
籙	lukr
鹿	lul
麓	lulb
胪	lulc
鹵	lulm
臚	luln
勎	lulo
勠	lulp
膔	lulq
膟	lulr
氇	lum
盧	lumm
氌	lumn
睩	lumo
盝	lump
馿	lumq
粶	lumr
騄	lums
騼	lumt
矑	lumu
鹭	lun
鸬	lunb
鷺	lunm
鸕	lunn
娽	luno
鴼	lunp
鵱	lunq
鵦	lunr
噜	luo
嚕	luom
嚧	luon
碌	lup
硉	lupm
硵	lupn
磠	lupo
磟	lupp
醁	luqm
獹	luqn
露	lur
曥	lurm
禄	lus
祿	lusm
峍	lusn
垆	lut
六	lutb
壚	lutm
圥	lutn
坴	luto
塷	lutp
塶	lutq
芦	luu
蘆	luum
菉	luun
蓾	luuo
蔍	luup
蕗	luuq
虂	luur
侓	luvm
僇	luvn
璐	luw
琭	luwm
璷	luwn
瓐	luwo
录	lux
彔	luxm
玈	luxn
鲁	luy
颅	luyb
鲈	luyc
魯	luym
顱	luyn
鱸	luyo
甪	luyp
翏	luyq
魲	luyr
謢	luys
鯥	luyt
路	luz
逯	luzb
舻	luzc
艫	luzm
迾	luzn
舮	luzo
趢	luzp
踛	luzq
蹗	luzr
艣	luzs
艪	luzt
捋	lva
捛	lvam
挔	lvan
寠	lvbm
瘻	lvbn
律	lvc
滤	lve
濾	lvem
绿	lvf
旅	lvfb
缕	lvfc
綠	lvfm
縷	lvfn
郘	lvfo
絽	lvfp
緑	lvfq
繂	lvfr
虑	lvh
稆	lvhb
穭	lvhm
焒	lvhn
爈	lvho
榈	lvi
櫚	lvim
櫨	lvin
梠	lvio
櫖	lvip
铝	lvj
鋁	lvjm
録	lvjn
鑢	lvjo
褛	lvk
簍	lvkm
褸	lvkn
箻	lvko
膂	lvl
膢	lvlm
膟	lvln
勴	lvlo
驴	lvm
闾	lvmb
驢	lvmm
閭	lvmn
氀	lvmo
瞜	lvmp
鷜	lvnm
吕	lvo
呂	lvom
哷	lvon
履	lvp
屡	lvpb
屢	lvpm
氯	lvq
膐	lvrm
祣	lvsm
嵂	lvsn
卛	lvso
垏	lvtm
蔞	lvum
葎	lvun
藘	lvuo
侣	lvv
偻	lvvb
侶	lvvm
僂	lvvn
儢	lvvo
率	lvx
慮	lvxm
慺	lvxn
謱	lvym
艣	lvzm
俩	lwv
倆	lwvm
慺	lwxm
拎	lxa
撛	lxam
凛	lxb
赁	lxbb
賃	lxbm
凜	lxbn
痳	lxbo
癝	lxbp
癛	lxbq
辚	lxc
臨	lxcm
轔	lxcn
轥	lxco
淋	lxe
潾	lxem
澟	lxen
瀶	lxeo
邻	lxf
鄰	lxfm
阾	lxfn
隣	lxfo
綝	lxfp
繗	lxfq
廪	lxg
廩	lxgm
焛	lxhm
燐	lxhn
林	lxi
檩	lxib
檁	lxim
橉	lxin
斴	lxjm
鏻	lxjn
箖	lxkm
临	lxl
麟	lxlb
膦	lxlc
麐	lxlm
粼	lxm
瞵	lxmb
冧	lxmm
粦	lxmn
閵	lxmo
驎	lxmp
吝	lxo
啉	lxob
磷	lxp
碄	lxpm
獜	lxqm
霖	lxr
晽	lxrm
暽	lxrn
嶙	lxs
厸	lxsm
崊	lxsn
疄	lxtm
壣	lxtn
蔺	lxu
藺	lxum
菻	lxun
倆	lxvm
亃	lxvn
僯	lxvo
琳	lxw
璘	lxwm
甐	lxwn
懔	lxx
懍	lxxm
恡	lxxn
悋	lxxo
惏	lxxp
鳞	lxy
鱗	lxym
翷	lxyn
顲	lxyo
遴	lxz
躏	lxzb
躪	lxzm
蹸	lxzn
躙	lxzo
掕	lyam
凌	lyb
皊	lybm
龄	lyc
蛉	lycb
齡	lycm
彾	lycn
衑	lyco
軨	lycp
輘	lycq
齢	lycr
刢	lydm
泠	lye
淩	lyem
澪	lyen
陵	lyf
绫	lyfb
聆	lyfc
酃	lyfd
綾	lyfm
紷	lyfn
灵	lyh
炩	lyhm
秢	lyhn
稜	lyho
燯	lyhp
爧	lyhq
棱	lyi
棂	lyib
柃	lyic
欞	lyim
櫺	lyin
铃	lyj
鈴	lyjm
錂	lyjn
袊	lykm
笭	lykn
裬	lyko
朎	lylm
竛	lyln
鹷	lylo
麢	lylp
龗	lylq
閝	lymm
駖	lymn
姈	lynm
鸰	lynn
婈	lyno
鴒	lynp
孁	lynq
另	lyo
呤	lyob
砱	lypm
狑	lyqm
醽	lyqn
零	lyr
靈	lyrm
昤	lyrn
霊	lyro
霗	lyrp
霝	lyrq
霛	lyrr
岭	lys
嶺	lysm
岺	lysn
崚	lyso
祾	lysp
坽	lytm
菱	lyu
苓	lyub
羐	lyum
蓤	lyun
蔆	lyuo
蕶	lyup
蘦	lyuq
令	lyv
伶	lyvb
倰	lyvm
玲	lyw
囹	lywb
瓴	lywc
琌	lywm
领	lyy
翎	lyyb
羚	lyyc
鲮	lyyd
領	lyym
鯪	lyyn
詅	lyyo
魿	lyyp
〇	lyz
夌	lyzm
舲	lyzn
跉	lyzo
蹸	lyzp
冷	lzb
稜	lzhm
棱	lzi
楞	lzib
欐	lziy
欚	lziz
睖	lzmm
唥	lzom
碐	lzpm
崚	lzsm
塄	lzt
堎	lztm
薐	lzum
倰	lzvm
愣	lzx
踜	lzzm
抹	maa
摩	maab
痲	mabm
痳	mabn
鬕	mabo
蚂	mac
蟆	macb
螞	macm
蟇	macn
溤	maem
杩	mai
榪	maim
鎷	majm
马	mam
麻	mamb
骂	mamc
麽	mamd
馬	mamm
閁	mamn
睰	mamo
駡	mamp
妈	man
媽	manm
嬤	mann
嫲	mano
犘	manp
鷌	manq
吗	mao
嘛	maob
唛	maoc
嗎	maom
嘜	maon
码	map
么	mapb
碼	mapm
亇	mapn
礣	mapo
犸	maq
獁	maqm
罵	masm
祃	masn
禡	maso
菻	maum
蔴	maun
傌	mavm
玛	maw
瑪	mawm
鰢	maym
孖	mazm
遤	mazn
贸	mcb
髦	mcbb
貿	mcbm
皃	mcbn
髳	mcbo
蝥	mcc
蟊	mccb
軞	mccm
蝐	mccn
泖	mce
渵	mcem
旄	mcf
鄚	mcfm
鄮	mcfn
緢	mcfo
戼	mchm
秏	mchn
枆	mcim
柕	mcin
楙	mcio
帽	mcj
卯	mcjb
锚	mcjc
铆	mcjd
鉚	mcjm
錨	mcjn
覒	mcjo
鉾	mcjp
袤	mck
笷	mckm
耄	mcl
毛	mcm
矛	mcmb
瞀	mcmc
毟	mcmm
眊	mcmn
毷	mcmo
氂	mcmp
牦	mcn
媢	mcnm
犛	mcnn
鶜	mcno
猫	mcq
酕	mcqm
昴	mcr
暓	mcrm
峁	mcs
罞	mcsm
嵍	mcsn
冒	mct
冇	mctm
冃	mctn
冐	mcto
堥	mctp
茂	mcu
茅	mcub
茆	mcuc
芼	mcum
萺	mcun
蓩	mcuo
乮	mcvm
瑁	mcw
瓱	mcwm
懋	mcx
夘	mcxm
愗	mcxn
貌	mcz
貓	mczm
買	mdbm
賣	mdbn
脉	mdl
劢	mdlb
脈	mdlm
勱	mdln
麦	mdm
麥	mdmm
鷶	mdnm
唛	mdo
嘪	mdom
霾	mdr
霡	mdrm
霢	mdrn
卖	mds
売	mdsm
埋	mdt
荬	mdu
蕒	mdum
薶	mdun
买	mdv
佅	mdvm
衇	mdxm
迈	mdz
邁	mdzm
濹	meem
庅	megm
麽	mem
麼	memm
嚒	meom
嚜	meon
嚰	meoo
么	mep
蛑	mfc
洠	mfem
缪	mff
繆	mffm
鞪	mfgm
某	mfi
桙	mfim
鍪	mfj
鉾	mfjm
劺	mflm
眸	mfm
麰	mfmm
牟	mfn
鴾	mfnm
哞	mfo
呣	mfom
堥	mftm
侔	mfv
敄	mfwm
恈	mfxm
谋	mfy
謀	mfym
踎	mfzm
扪	mga
捫	mgam
殙	mgdm
満	mgem
鞔	mgg
焖	mgh
燜	mghm
穈	mghn
椚	mgim
钔	mgj
鍆	mgjm
门	mgm
闷	mgmb
門	mgmm
瞞	mgmn
閅	mgmo
暪	mgrm
亹	mgtm
菛	mgum
虋	mgun
们	mgv
們	mgvm
玧	mgwm
璊	mgwn
斖	mgwo
懑	mgx
悶	mgxm
懣	mgxn
怋	mgxo
悗	mgxp
惛	mgxq
痝	mhbm
蟒	mhc
厖	mhcm
蛖	mhcn
蠎	mhco
漭	mhe
汒	mhem
浝	mhen
邙	mhf
庬	mhgm
杧	mhim
杗	mhin
铓	mhjm
釯	mhjn
鋩	mhjo
笀	mhkm
朚	mhlm
龒	mhln
盲	mhm
盳	mhmm
駹	mhmn
牤	mhnm
娏	mhnn
牻	mhno
吂	mhom
哤	mhon
硭	mhp
硥	mhpm
狵	mhqm
氓	mhs
壾	mhsm
芒	mhu
茫	mhub
莽	mhuc
莾	mhum
茻	mhun
蘉	mhuo
忙	mhx
恾	mhxm
尨	mhym
摵	miam
擟	mian
攠	miao
宓	mib
羋	mibm
宻	mibn
蜜	mic
蝆	micm
镾	micn
鼏	midm
泌	mie
汩	mieb
汨	miec
沕	miem
沵	mien
洣	mieo
淧	miep
渳	mieq
漞	mier
滵	mies
濗	miet
濔	mieu
瀰	miev
灖	miew
靡	mif
糸	mifb
縻	mifc
弥	mig
弭	migb
彌	migm
秘	mih
熐	mihm
穈	mihn
爢	miho
枈	miim
榓	miin
樒	miio
檷	miip
櫁	miiq
觅	mij
覓	mijm
覔	mijn
幎	mijo
覛	mijp
銤	mijq
幦	mijr
袮	mikm
簚	mikn
麋	mil
脒	milb
麊	milm
麛	miln
米	mim
眯	mimb
糜	mimc
幂	mimd
敉	mime
冖	mimf
瞇	mimm
冪	mimn
冞	mimo
粎	mimp
瞴	mimq
麿	mimr
孊	minm
鸍	minn
咪	mio
嘧	miob
猕	miq
醚	miqb
獼	miqm
醾	miqn
醿	miqo
釄	miqp
密	mis
祢	misb
禰	mism
峚	misn
祕	miso
羃	misp
塓	mitm
蘼	miu
芈	miub
蒾	mium
葞	miun
蓂	miuo
蔝	miup
蔤	miuq
藌	miur
蘪	mius
侎	mivm
瓕	miwm
尓	mixm
尒	mixn
怽	mixo
戂	mixp
谜	miy
谧	miyb
謎	miym
謐	miyn
詸	miyo
迷	miz
宀	mjb
蝒	mjcm
免	mjd
湎	mje
沔	mjeb
渑	mjec
澠	mjem
汅	mjen
绵	mjf
缅	mjfb
綿	mjfm
緬	mjfn
絻	mjfo
緜	mjfp
丏	mjhm
棉	mji
杣	mjim
檰	mjin
櫋	mjio
勉	mjl
腼	mjlb
勔	mjlm
面	mjm
眠	mjmb
眄	mjmc
黽	mjmm
靦	mjmn
靣	mjmo
睌	mjmp
麫	mjmq
麪	mjmr
糆	mjms
麺	mjmt
矈	mjmu
矊	mjmv
麵	mjmw
矏	mjmx
娩	mjn
婂	mjnm
媔	mjnn
嬵	mjno
喕	mjom
牑	mjpm
冕	mjt
芇	mjum
莬	mjun
葂	mjuo
俛	mjvm
偭	mjvn
愐	mjxm
鮸	mjym
臱	mjzm
摱	mlam
匁	mlbm
鬗	mlbn
鬘	mlbo
蛮	mlc
螨	mlcb
蠻	mlcm
蟎	mlcn
蟃	mlco
满	mle
漫	mleb
滿	mlem
満	mlen
澫	mleo
澷	mlep
缦	mlf
縵	mlfm
鄤	mlfn
絻	mlfo
鞔	mlg
熳	mlh
樠	mlim
槾	mlin
幔	mlj
镘	mljb
鏝	mljm
鏋	mljn
襔	mlkm
瞒	mlm
瞞	mlmm
睌	mlmn
矕	mlmo
姏	mlnm
娨	mlnn
嫚	mlno
屘	mlpm
獌	mlqm
曼	mlr
馒	mls
饅	mlsm
埋	mlt
墁	mltb
蔓	mlu
蔄	mlum
蘰	mlun
僈	mlvm
慢	mlx
悗	mlxm
慲	mlxn
鳗	mly
谩	mlyb
颟	mlyc
謾	mlym
顢	mlyn
鰻	mlyo
描	mma
渺	mme
淼	mmeb
缈	mmf
缪	mmfb
緲	mmfm
繆	mmfn
緢	mmfo
庙	mmg
廟	mmgm
庿	mmgn
秒	mmh
杪	mmi
篎	mmkm
劰	mmlm
竗	mmln
瞄	mmm
眇	mmmb
妙	mmn
鹋	mmnb
鶓	mmnm
媌	mmnn
嫹	mmno
喵	mmo
呒	mmob
嘸	mmom
呣	mmon
厸	mmsm
苗	mmu
藐	mmub
仯	mmvm
玅	mmxm
訬	mmym
鱙	mmyn
邈	mmz
缪	mnf
繆	mnfm
谬	mny
謬	mnym
摸	moa
摩	moab
抹	moac
摹	moad
擵	moam
攠	moan
寞	mob
瘼	mobb
皌	mobm
癦	mobn
蛨	mocm
蟔	mocn
殁	mod
歿	modm
歾	modn
劘	modo
漠	moe
没	moeb
沫	moec
沒	moem
瀎	moen
陌	mof
絈	mofm
絔	mofn
縸	mofo
纆	mofp
魔	mog
庅	mogm
靺	mogn
骳	mogo
髍	mogp
默	moh
万	mohb
秣	mohc
無	mohm
黙	mohn
爅	moho
模	moi
末	moib
枺	moim
橅	moin
镆	moj
鏌	mojm
帓	mojn
帞	mojo
銆	mojp
袹	mokm
脉	mol
膜	molb
耱	molc
蓦	mom
麽	momb
麼	momm
驀	momn
眜	momo
眿	momp
眽	momq
粖	momr
瞙	moms
瞐	momt
糢	momu
麿	momv
嬷	mon
嫫	monb
嬤	monm
妺	monn
嫼	mono
呒	moo
嘿	moob
唜	moom
嗼	moon
嚜	mooo
嚤	moop
么	mop
磨	mopb
砞	mopm
礳	mopn
狢	moqm
獏	moqn
昩	morm
暯	morn
馍	mos
饃	mosm
饝	mosn
墨	mot
冒	motb
圽	motm
冐	motn
塻	moto
莫	mou
茉	moub
蘑	mouc
萬	moum
莈	moun
藦	mouo
尛	moxm
衇	moxn
懡	moxo
戂	moxp
谟	moy
謨	moym
魹	moyn
魩	moyo
謩	moyp
貊	moz
貘	mozb
貃	mozm
貈	mozn
抺	mpam
挴	mpan
攗	mpao
寐	mpb
凂	mpbm
痗	mpbn
蝞	mpcm
徾	mpcn
殙	mpdm
没	mpe
湄	mpeb
浼	mpec
沒	mpem
沬	mpen
湈	mpeo
渼	mpep
郿	mpfm
魅	mpg
鬽	mpgm
煤	mph
黴	mphm
煝	mphn
穈	mpho
燘	mphp
黣	mphq
梅	mpi
枚	mpib
楣	mpic
栂	mpim
楳	mpin
槑	mpio
櫗	mpip
镁	mpj
镅	mpjb
鎂	mpjm
鎇	mpjn
鋂	mpjo
袂	mpk
篃	mpkm
脄	mplm
脢	mpln
腜	mplo
每	mpm
眉	mpmb
糜	mpmc
毎	mpmm
眛	mpmn
睂	mpmo
睸	mpmp
妹	mpn
媚	mpnb
媒	mpnc
鹛	mpnd
鶥	mpnm
媄	mpnn
媺	mpno
嬍	mpnp
嚜	mpom
酶	mpq
猸	mpqb
霉	mpr
昧	mprb
嵋	mps
祙	mpsm
嵄	mpsn
禖	mpso
躾	mpsp
坆	mptm
堳	mptn
塺	mpto
莓	mpu
苺	mpum
葿	mpun
蘪	mpuo
玫	mpw
珻	mpwm
瑂	mpwn
韎	mpwo
美	mpy
謎	mpym
羙	mpyn
跊	mpzm
搣	mtam
蠛	mtc
滅	mtem
瀎	mten
旀	mtfm
灭	mth
烕	mthm
櫗	mtim
覕	mtjm
幭	mtjn
鑖	mtjo
篾	mtk
簚	mtkm
眜	mtmm
鴓	mtnm
咩	mto
吀	mtom
哶	mton
礣	mtpm
蔑	mtu
薎	mtum
乜	mtv
懱	mtxm
衊	mtxn
鱴	mtym
孭	mtzm
拇	mua
蚞	mucm
沐	mue
繆	mufm
縸	mufn
鞪	mugm
穆	muh
炑	muhm
木	mui
模	muib
朰	muim
朷	muin
楘	muio
樢	muip
幕	muj
钼	mujb
鉬	mujm
凩	mujn
幙	mujo
鉧	mujp
募	mul
胟	mulm
母	mum
目	mumb
睦	mumc
毪	mumd
毣	mumm
氁	mumn
牧	mun
姆	munb
姥	munc
牡	mund
牟	mune
牳	munm
娒	munn
呒	muo
嘸	muom
呣	muon
砪	mupm
狇	muqm
獏	muqn
暮	mur
雮	murm
暯	murn
霂	muro
峔	musm
亩	mut
墓	mutb
坶	mutc
畝	mutm
畂	mutn
畒	muto
畆	mutp
畞	mutq
畮	mutr
苜	muu
莯	muum
萺	muun
茻	muuo
仫	muv
慕	mux
慔	muxm
踇	muzm
艒	muzn
抿	mxa
捪	mxam
冺	mxbm
痻	mxbn
賯	mxbo
蠠	mxcm
刡	mxdm
泯	mxe
湣	mxem
渂	mxen
湏	mxeo
潣	mxep
缗	mxf
緡	mxfm
緍	mxfn
鈱	mxjm
錉	mxjn
鍲	mxjo
笽	mxkm
笢	mxkn
簢	mxko
勄	mxlm
闽	mxm
闵	mxmb
皿	mxmc
黾	mxmd
閩	mxmm
閔	mxmn
黽	mxmo
盿	mxmp
姄	mxnm
鴖	mxnn
呡	mxom
砇	mxpm
碈	mxpn
旻	mxrm
旼	mxrn
暋	mxro
民	mxs
岷	mxsb
罠	mxsm
崏	mxsn
垊	mxtm
苠	mxu
僶	mxvm
敏	mxw
玟	mxwb
珉	mxwc
瑉	mxwm
敃	mxwn
琝	mxwo
琘	mxwp
敯	mxwq
悯	mxx
愍	mxxb
憫	mxxm
忟	mxxn
忞	mxxo
怋	mxxp
惽	mxxq
慜	mxxr
鳘	mxy
鰵	mxym
掵	myam
凕	mybm
螟	myc
溟	mye
洺	myem
鄍	myfm
椧	myim
榠	myin
铭	myj
銘	myjm
覭	myjn
朙	mylm
冥	mym
瞑	mymb
眀	mymm
眳	mymn
鸣	myn
鳴	mynm
姳	mynn
嫇	myno
名	myo
酩	myq
猽	myqm
明	myr
暝	myrb
茗	myu
蓂	myum
命	myv
佲	myvm
慏	myxm
詺	myym
掹	mzam
擝	mzan
髳	mzbm
蜢	mzc
虻	mzcb
蠓	mzcc
蝱	mzcm
溕	mzem
濛	mzen
鄸	mzfm
鄳	mzfn
庬	mzgm
梦	mzi
檬	mzib
橗	mzim
锰	mzj
錳	mzjm
鋂	mzjn
幪	mzjo
朦	mzl
勐	mzlb
盟	mzm
瞢	mzmb
黽	mzmm
冡	mzmn
氋	mzmo
矇	mzmp
矒	mzmq
鼆	mzmr
鹲	mznm
鸏	mznn
礞	mzp
猛	mzq
獴	mzqm
雺	mzrm
曚	mzrn
霥	mzro
靀	mzrp
霿	mzrq
氓	mzs
罞	mzsm
饛	mzsn
甿	mztm
蒙	mzu
萌	mzub
莔	mzum
萠	mzun
蕄	mzuo
儚	mzvm
甍	mzw
瓾	mzwm
懵	mzx
夢	mzxm
夣	mzxn
懜	mzxo
懞	mzxp
尨	mzym
鯍	mzyn
鯭	mzyo
顭	mzyp
孟	mzz
艨	mzzb
艋	mzzc
拿	naa
捺	naab
抐	naam
拏	naan
挐	naao
搻	naap
軜	nacm
那	naf
纳	nafb
納	nafm
郍	nafn
靹	nagm
秅	nahm
钠	naj
镎	najb
鈉	najm
鎿	najn
衲	nak
袦	nakm
笚	nakn
笝	nako
肭	nal
乸	namm
娜	nan
妠	nanm
哪	nao
呐	naob
吶	naom
嗱	naon
雫	narm
蒘	naum
蒳	naun
讷	nay
魶	naym
誽	nayn
豽	nazm
貀	nazn
挠	nca
撓	ncam
摎	ncan
匘	ncbm
蛲	ncc
蟯	nccm
鬧	ncdm
淖	nce
橈	ncim
铙	ncj
鐃	ncjm
脑	ncl
腦	nclm
脳	ncln
臑	nclo
闹	ncm
閙	ncmm
婥	ncnm
嫐	ncnn
呶	nco
硇	ncp
碙	ncpm
碯	ncpn
猱	ncq
峱	ncqm
獶	ncqn
獿	ncqo
嶩	ncsm
巎	ncsn
垴	nct
堖	nctm
瑙	ncw
恼	ncx
惱	ncxm
怓	ncxn
悩	ncxo
憹	ncxp
詉	ncym
譊	ncyn
孬	ncz
夒	nczm
搱	ndam
摨	ndan
疓	ndbm
螚	ndcm
奈	ndd
鼐	nddb
耐	nde
耏	ndem
渿	nden
柰	ndi
釢	ndjm
銰	ndjn
錼	ndjo
褦	ndkm
腉	ndlm
奶	ndn
妳	ndnm
嬭	ndnn
乃	ndp
氖	ndq
萘	ndu
艿	ndub
莻	ndum
佴	ndv
倷	ndvm
廼	ndym
迺	ndzm
孻	ndzn
抐	neam
疒	neb
眲	nemm
呢	neo
哪	neob
呐	neoc
吶	neom
讷	ney
訥	neym
搙	nfam
槈	nfim
檽	nfin
鎒	nfjm
鐞	nfjn
耨	nfl
獳	nfqm
譨	nfym
羺	nfyn
疟	ngb
瘧	ngbm
虐	ngh
嫩	ngn
婩	ngnm
媆	ngnn
嗯	ngo
唔	ngob
硸	ngpm
恁	ngx
攮	nha
搑	nham
擃	nhan
鬞	nhbm
齉	nhbn
蠰	nhcm
涳	nhem
瀼	nhen
灢	nheo
囊	nhh
嚢	nhhm
欜	nhim
囔	nho
曩	nhr
馕	nhs
饢	nhsm
乪	nhvm
儾	nhvn
憹	nhxm
拟	nia
擬	niam
抐	nian
抳	niao
掜	niap
屰	nibm
蚭	nicm
蛪	nicn
蜺	nico
輗	nicp
齯	nicq
泥	nie
溺	nieb
兒	niem
灄	nien
氼	nieo
児	niep
淣	nieq
濔	nier
匿	nif
旎	nifb
郳	nifm
聣	nifn
縌	nifo
隬	nifp
聻	nifq
秜	nihm
柅	niim
棿	niin
檷	niio
铌	nij
鈮	nijm
觬	nijn
袮	nikm
腻	nil
膩	nilm
胒	niln
麑	nilo
睨	nim
籾	nimm
眤	nimn
妮	nin
妳	ninm
婗	ninn
嫟	nino
嬺	ninp
嬭	ninq
呢	nio
尼	nip
屔	nipm
猊	niq
狔	niqm
霓	nir
昵	nirb
晲	nirm
暱	nirn
臡	niro
坭	nit
堄	nitm
埿	nitn
蘼	niu
苨	nium
薿	niun
你	niv
倪	nivb
伲	nivc
伱	nivm
儞	nivn
儗	nivo
怩	nix
惄	nixm
愵	nixn
馜	nixo
懝	nixp
鲵	niy
鯢	niym
誽	niyn
逆	niz
迡	nizm
跜	nizn
孴	nizo
貎	nizp
捻	nja
拈	njab
撵	njac
撚	njam
攆	njan
辗	njc
辇	njcb
輾	njcm
輦	njcn
涊	njem
淰	njen
溓	njeo
黏	njh
廿	njhb
秊	njhm
秥	njhn
焾	njho
榐	njim
簐	njkm
粘	njm
姩	njnm
鵇	njnn
哖	njom
唸	njon
年	njp
碾	njpb
卄	njsm
埝	njt
蔫	nju
念	njx
悥	njxm
惗	njxn
鲇	njy
鲶	njyb
鮎	njym
鯰	njyn
跈	njzm
艌	njzn
蹍	njzo
蹨	njzp
躎	njzq
黁	nkmm
嫰	nknm
抩	nlam
揇	nlan
赧	nlc
蝻	nlcb
湳	nlem
煵	nlhm
楠	nli
枏	nlim
柟	nlin
腩	nll
妠	nlnm
娚	nlnn
婻	nlno
嫨	nlnp
喃	nlo
暔	nlrm
南	nls
男	nlt
畘	nltm
莮	nlum
萳	nlun
侽	nlvm
囡	nlw
囝	nlwb
戁	nlxm
諵	nlym
难	nlz
難	nlzm
遖	nlzn
溺	nme
樢	nmim
袅	nmk
裊	nmkm
褭	nmkn
脲	nml
鸟	nmn
嬲	nmnb
鳥	nmnm
嫋	nmnn
嬝	nmno
尿	nmp
茑	nmu
蔦	nmum
扭	nna
拗	nnab
抝	nnam
汼	nnem
沑	nnen
纽	nnf
紐	nnfm
靵	nngm
炄	nnhm
杻	nnim
钮	nnj
鈕	nnjm
牛	nnn
妞	nnnb
牜	nnnm
嗯	nno
唔	nnob
狃	nnq
莥	nnum
忸	nnx
怓	nnxm
挪	noa
搦	noab
挼	noam
掿	noan
搙	noao
搻	noap
耎	noem
稬	nohm
穤	nohn
梛	noim
榒	noin
橠	noio
锘	noj
鍩	nojm
袳	nokm
袲	nokn
糯	nom
毭	nomm
糑	nomn
糥	nomo
娜	non
喏	noo
傩	nov
儺	novm
懦	nox
愞	noxm
懧	noxn
诺	noy
諾	noym
詝	noyn
難	nozm
逽	nozn
蹃	nozo
浽	npem
那	npf
錗	npjm
脮	nplm
腇	npln
娞	npnm
哪	npo
氝	npqm
氞	npqn
內	nprm
馁	nps
餒	npsm
餧	npsn
内	npt
鮾	npym
鯘	npyn
娘	nqn
嬢	nqnm
孃	nqnn
酿	nqq
釀	nqqm
醸	nqqn
渜	nrem
湪	nren
煗	nrhm
煖	nrhn
奻	nrnm
暖	nrr
餪	nrsm
挊	nsam
挵	nsan
癑	nsbm
鬞	nsbn
齈	nsbo
農	nscm
辳	nscn
浓	nse
濃	nsem
繷	nsfm
弄	nsg
秾	nshm
燶	nshn
穠	nsho
檂	nsim
欁	nsin
襛	nskm
脓	nsl
膿	nslm
农	nsm
哝	nso
噥	nsom
醲	nsqm
禯	nssm
蕽	nsum
侬	nsv
儂	nsvm
譨	nsym
捏	nta
摄	ntab
攝	ntam
掜	ntan
揑	ntao
摰	ntap
痆	ntbm
齧	ntcm
蠥	ntcn
涅	nte
湼	ntem
聂	ntf
陧	ntfb
聶	ntfm
隉	ntfn
枿	ntim
槷	ntin
櫱	ntio
镊	ntj
镍	ntjb
鎳	ntjm
鑷	ntjn
帇	ntjo
銸	ntjp
鋷	ntjq
錜	ntjr
鑈	ntjs
钀	ntjt
篞	ntkm
籋	ntkn
闑	ntmm
糵	ntmn
糱	ntmo
啮	nto
嗫	ntob
嚙	ntom
囁	nton
噛	ntoo
囐	ntop
囓	ntoq
峊	ntsm
嵲	ntsn
嶭	ntso
巕	ntsp
圼	nttm
蘖	ntu
苶	ntum
菍	ntun
乜	ntv
敜	ntwm
颞	nty
顳	ntym
讘	ntyn
孽	ntz
蹑	ntzb
臬	ntzc
躡	ntzm
踂	ntzn
踙	ntzo
踗	ntzp
臲	ntzq
孼	ntzr
搙	nuam
弩	nug
帑	nuj
笯	nukm
努	nul
驽	num
駑	numm
奴	nun
砮	nupm
胬	nur
伮	nuvm
傉	nuvn
怒	nux
孥	nuz
沑	nvem
聏	nvfm
钕	nvj
釹	nvjm
朒	nvlm
籹	nvmm
女	nvn
恧	nvx
衄	nvxb
衂	nvxm
拰	nxam
脌	nxlm
囜	nxwm
您	nxx
拧	nya
擰	nyam
宁	nyb
凝	nybb
寧	nybm
寕	nybn
寍	nybo
寗	nybp
寜	nybq
鬡	nybr
泞	nye
濘	nyem
澝	nyen
聍	nyf
聹	nyfm
柠	nyi
檸	nyim
橣	nyin
鑏	nyjm
矃	nymm
嬣	nynm
鸋	nynn
咛	nyo
嚀	nyom
狞	nyq
獰	nyqm
苧	nyum
薴	nyun
佞	nyv
侫	nyvm
倿	nyvn
儜	nyvo
甯	nyy
螚	nzcm
能	nzl
筽	ookm
哦	ooo
喔	ooob
噢	oooc
嚄	ooom
沤	oue
漚	ouem
区	ouf
區	oufm
髃	ougm
熰	ouhm
櫙	ouim
鏂	oujm
耦	oul
腢	oulm
膒	ouln
鸥	oun
鷗	ounm
鴎	ounn
呕	ouo
嘔	ouom
吘	ouon
吽	ouoo
殴	oup
毆	oupm
欧	ouq
歐	ouqm
塸	outm
藕	ouu
蕅	ouum
藲	ouun
偶	ouv
瓯	ouw
甌	ouwm
怄	oux
慪	ouxm
讴	ouy
謳	ouym
扒	paa
掱	paam
皅	pabm
汃	paem
潖	paen
杷	pai
帕	paj
钯	pajb
鈀	pajm
帊	pajn
筢	pak
袙	pakm
耙	pal
妑	panm
啪	pao
葩	pau
苩	paum
琶	paw
怕	pax
爬	paz
趴	pazb
舥	pazm
跁	pazn
抛	pca
拋	pcam
疱	pcb
蚫	pccm
軳	pccn
刨	pcd
匏	pcdb
奅	pcdm
泡	pce
颮	pcfm
庖	pcg
瓟	pcgm
鞄	pcgn
炮	pch
炰	pchm
烰	pchn
穮	pcho
鉋	pcjm
鑤	pcjn
袍	pck
袌	pckm
褜	pckn
脬	pcl
麅	pclm
脟	pcln
麃	pclo
靤	pcmm
麭	pcmn
咆	pco
嚗	pcom
皰	pcpm
砲	pcpn
礟	pcpo
礮	pcpp
狍	pcq
垉	pctm
萢	pcum
藨	pcun
跑	pcz
爮	pczm
跁	pczn
排	pda
拍	pdab
徘	pdc
輫	pdcm
派	pde
湃	pdeb
沠	pdem
渒	pden
棑	pdim
鎃	pdjm
箄	pdkm
簰	pdkn
簲	pdko
闏	pdmm
犤	pdnm
哌	pdo
牌	pdp
猅	pdqm
蒎	pdu
俳	pdv
廹	pdym
迫	pdz
掊	pfa
抔	pfam
抙	pfan
捊	pfao
剖	pfd
棓	pfim
裒	pfk
箁	pfkm
襃	pfkn
娝	pfnm
婄	pfnn
犃	pfno
咅	pfom
哣	pfon
垺	pftm
湓	pge
濆	pgem
衯	pgkm
盆	pgm
喷	pgo
噴	pgom
呠	pgon
喯	pgoo
歕	pgqm
葐	pgum
瓫	pgwm
翉	pgym
翸	pgyn
髣	phbm
彷	phc
螃	phcb
厐	phcm
徬	phcn
滂	phe
汸	phem
沗	phen
旁	phf
庞	phg
庬	phgm
髈	phgn
炐	phhm
覫	phjm
篣	phkm
胖	phl
膀	phlb
耪	phlc
龐	phlm
肨	phln
胮	phlo
膖	phlp
龎	phlq
眫	phmm
嫎	phnm
嗙	phom
磅	php
乓	phpb
雱	phrm
霶	phrn
攵	phw
尨	phym
鳑	phyn
鰟	phyo
逄	phz
夂	phzb
夆	phzm
趽	phzn
舽	phzo
批	pia
披	piab
擗	piac
抷	piam
揊	pian
疲	pib
痞	pibb
癖	pibc
毘	pibm
髬	pibn
蚍	pic
蜱	picb
蚽	picm
蚾	picn
螕	pico
螷	picp
蠯	picq
劈	pid
淠	pie
潎	piem
澼	pien
匹	pif
纰	pifb
邳	pifc
陂	pifd
陴	pife
郫	piff
紕	pifm
阰	pifn
旇	pifo
隦	pifp
鼙	pig
庀	pigb
鞞	pigm
丕	pih
炋	pihm
秠	pihn
秛	piho
焷	pihp
稫	pihq
枇	pii
枈	piim
椑	piin
榌	piio
铍	pij
鈹	pijm
鈚	pijn
釽	pijo
鉟	pijp
鈲	pijq
銢	pijr
銔	pijs
錍	pijt
錃	piju
鎞	pijv
被	pik
裨	pikb
笓	pikm
箆	pikn
篺	piko
脾	pil
肶	pilm
耚	piln
脴	pilo
腗	pilp
膍	pilq
睥	pim
毞	pimm
粃	pimn
駓	pimo
闢	pimp
媲	pin
妚	pinm
嫓	pinn
鴄	pino
鵧	pinp
鷿	pinq
鸊	pinr
啤	pio
否	piob
噼	pioc
噽	piom
嚊	pion
嚭	pioo
皮	pip
屁	pipb
砒	pipc
磇	pipm
礔	pipn
礕	pipo
狉	piqm
狓	piqn
猈	piqo
霹	pir
朇	pirm
罴	pis
罷	pism
羆	pisn
岯	piso
崥	pisp
禆	pisq
嶏	pisr
毗	pit
坯	pitb
圮	pitc
埤	pitd
壀	pitm
疈	pitn
芘	piu
苉	pium
僻	piv
仳	pivb
伓	pivm
伾	pivn
琵	piw
甓	piwb
辟	pix
怶	pixm
悂	pixn
憵	pixo
譬	piy
翍	piym
鲏	piyn
魮	piyo
諀	piyp
魾	piyq
鮍	piyr
貔	piz
疋	pizb
豼	pizm
豾	pizn
貵	pjbm
賆	pjbn
緶	pjfm
骿	pjgm
扁	pjh
楩	pjim
楄	pjin
覑	pjjm
篇	pjk
胼	pjl
腁	pjlm
骗	pjm
骈	pjmb
騙	pjmm
駢	pjmn
騈	pjmo
騗	pjmp
犏	pjn
媥	pjnm
鶣	pjnn
片	pjp
猵	pjqm
獱	pjqn
偏	pjv
便	pjvb
囨	pjwm
瑸	pjwn
璸	pjwo
翩	pjy
谝	pjyb
諞	pjym
魸	pjyn
諚	pjyo
蹁	pjz
跰	pjzm
攀	pla
拚	plab
搫	plam
冸	plbm
蟠	plc
判	pld
潘	ple
泮	pleb
沜	plem
洀	plen
湴	pleo
溿	plep
瀊	pleq
縏	plfm
鞶	plgm
炍	plhm
柈	plim
槃	plin
幋	pljm
鋬	pljn
鎜	pljo
鑻	pljp
袢	plk
襻	plkb
褩	plkm
籓	plkn
胖	pll
肨	pllm
膰	plln
盘	plm
盼	plmb
盤	plmm
眅	plmn
盻	plmo
眫	plmp
闆	plmq
媻	plnm
鵥	plnn
磐	plp
爿	plpb
丬	plpc
牉	plpm
碆	plpn
牓	plpo
磻	plpp
畔	plt
番	pltb
坢	pltm
畨	pltn
萠	plum
蒰	plun
叛	ply
詊	plym
頖	plyn
蹒	plz
蹣	plzm
跘	plzn
髟	pmb
皫	pmbm
螵	pmc
徱	pmcm
剽	pmd
殍	pmdb
漂	pme
飘	pmf
缥	pmfb
飄	pmfm
縹	pmfn
旚	pmfo
飃	pmfp
瓢	pmg
魒	pmgm
朴	pmi
篻	pmkm
勡	pmlm
瞟	pmm
骠	pmmb
驃	pmmm
闝	pmmn
驫	pmmo
嫖	pmn
犥	pmnm
嘌	pmo
醥	pmqm
票	pms
彯	pmsm
莩	pmu
蔈	pmum
薸	pmun
僄	pmvm
慓	pmxm
鰾	pmym
翲	pmyn
謤	pmyo
顠	pmyp
掊	poa
搫	poam
魄	pob
皤	pobb
髲	pobm
尀	pocm
尃	pocn
奤	podm
泼	poe
泊	poeb
泺	poec
潑	poem
濼	poen
洦	poeo
湐	poep
溌	poeq
叵	pof
繁	pofb
鄱	pofc
陂	pofd
髆	pogm
烞	pohm
朴	poi
桲	poim
櫇	poin
钋	poj
钷	pojb
釙	pojm
鉕	pojn
巿	pojo
鏺	pojp
笸	pok
箥	pokm
粕	pom
駊	pomm
婆	pon
哱	poom
嘙	poon
嚩	pooo
破	pop
颇	popb
砶	popm
酦	poqm
猼	poqn
醗	poqo
醱	poqp
昢	porm
岶	posm
岥	posn
坡	pot
蒪	poum
蔢	poun
珀	pow
攴	powb
敀	powm
馞	poxm
覇	poxn
頗	poym
廹	poyn
翍	poyo
謈	poyp
迫	poz
抷	ppam
攈	ppan
赔	ppb
賠	ppbm
轡	ppcm
沛	ppe
浿	ppem
陪	ppf
旆	ppfb
阫	ppfm
斾	ppfn
陫	ppfo
柸	ppim
柭	ppin
棑	ppio
帔	ppj
锫	ppjb
錇	ppjm
裴	ppk
裶	ppkm
裵	ppkn
胚	ppl
肧	pplm
毰	ppmm
馷	ppmn
妚	ppnm
姵	ppnn
婄	ppno
媐	ppnp
呸	ppo
辔	ppob
配	ppq
醅	ppqb
犻	ppqm
霈	ppr
嶏	ppsm
培	ppt
茷	ppum
蓜	ppun
佩	ppv
伂	ppvm
俖	ppvn
珮	ppwm
琣	ppwn
怌	ppxm
衃	ppxn
撇	pta
撆	ptam
潎	ptem
覕	ptjm
鐅	ptjn
瞥	ptm
嫳	ptnm
丿	ptp
氕	ptq
暼	ptrm
彡	pts
苤	ptu
扑	pua
撲	puam
抪	puan
捗	puao
擈	puap
匍	pub
痡	pubm
贌	pubn
瀑	pue
浦	pueb
濮	puec
溥	pued
潽	puem
陠	pufm
纀	pufn
巬	pugm
炇	puhm
烳	puhn
秿	puho
穙	puhp
朴	pui
樸	puim
柨	puin
檏	puio
铺	puj
镨	pujb
镤	pujc
鋪	pujm
鏷	pujn
鐠	pujo
襆	pukm
箁	pukn
脯	pul
氆	pum
毬	pumm
駇	pumn
瞨	pumo
鵏	punm
噗	puo
酺	puqm
獛	puqn
普	pur
暴	purb
曝	purc
暜	purm
埔	put
堡	putb
圤	putm
墣	putn
菩	puu
葡	puub
蒲	puuc
莆	puud
蒱	puum
仆	puv
僕	puvm
舖	puvn
舗	puvo
圃	puw
璞	puwb
攴	puwc
圑	puwm
谱	puy
譜	puym
菐	puyn
諩	puyo
鯆	puyp
蹼	puz
拼	pxa
拚	pxab
贫	pxb
貧	pxbm
蠙	pxcm
汖	pxem
聘	pxf
穦	pxhm
榀	pxi
朩	pxim
矉	pxmm
驞	pxmn
嫔	pxn
姘	pxnb
牝	pxnc
嬪	pxnm
娦	pxnn
品	pxo
嚬	pxom
砏	pxpm
礗	pxpn
蘋	pxum
薲	pxun
玭	pxwm
琕	pxwn
馪	pxxm
频	pxy
颦	pxyb
頻	pxym
顰	pxyn
冯	pyb
蚲	pycm
蛢	pycn
軿	pyco
輧	pycp
泙	pyem
洴	pyen
涄	pyeo
淜	pyep
郱	pyfm
聠	pyfn
缾	pyfo
庰	pygm
平	pyh
焩	pyhm
枰	pyi
檘	pyim
凭	pyj
帡	pyjm
帲	pyjn
幈	pyjo
鉼	pyjp
凴	pyjq
箳	pykm
簈	pykn
胓	pylm
竮	pyln
馮	pymm
娉	pyn
呯	pyom
屏	pyp
乒	pypb
砯	pypm
硑	pypn
屛	pypo
岼	pysm
艵	pysn
坪	pyt
甹	pytm
塀	pytn
苹	pyu
萍	pyub
蘋	pyum
荓	pyun
蓱	pyuo
俜	pyv
倗	pyvm
瓶	pyw
玶	pywm
甁	pywn
憑	pyxm
慿	pyxn
评	pyy
鲆	pyyb
評	pyym
鮃	pyyn
頩	pyyo
捧	pza
抨	pzab
挷	pzam
捀	pzan
掽	pzao
摓	pzap
搒	pzaq
匉	pzbm
皏	pzbn
痭	pzbo
髼	pzbp
鬅	pzbq
鬔	pzbr
蟛	pzc
軯	pzcm
輧	pzcn
輣	pzco
蟚	pzcp
剻	pzdm
澎	pze
泙	pzem
淎	pzen
淜	pzeo
漨	pzep
漰	pzeq
絣	pzfm
纄	pzfn
弸	pzgm
烹	pzh
稝	pzhm
熢	pzhn
棚	pzi
梈	pzim
椪	pzin
椖	pzio
樥	pzip
槰	pziq
錋	pzjm
鑝	pzjn
篷	pzk
竼	pzkm
袶	pzkn
篣	pzko
朋	pzl
膨	pzlb
胓	pzlm
閛	pzmm
駍	pzmn
騯	pzmo
鹏	pzn
鵬	pznm
嘭	pzo
碰	pzp
砰	pzpb
硼	pzpc
硑	pzpm
磞	pzpn
彭	pzs
堋	pzt
塳	pztm
塜	pztn
蓬	pzu
芃	pzum
莑	pzun
蘕	pzuo
伻	pzvm
倗	pzvn
傰	pzvo
怦	pzx
恲	pzxm
憉	pzxn
韸	pzym
韼	pzyn
踫	pzzm
搉	qgam
瘸	qgb
蚗	qgcm
汋	qgem
缺	qgf
缼	qgfm
炔	qgh
燩	qghm
榷	qgi
棤	qgim
却	qgj
卻	qgjm
阙	qgm
阕	qgmb
闋	qgmm
闕	qgmn
鹊	qgn
鵲	qgnm
确	qgp
確	qgpm
殻	qgpn
硞	qgpo
皵	qgpp
碏	qgpq
毃	qgpr
碻	qgps
礐	qgpt
礭	qgpu
崅	qgsm
埆	qgtm
塙	qgtn
墧	qgto
蒛	qgum
傕	qgvm
琷	qgwm
敠	qgwn
敪	qgwo
悫	qgx
愨	qgxm
慤	qgxn
雀	qgz
趞	qgzm
躤	qgzn
扢	qiam
扱	qian
掑	qiao
捿	qiap
摖	qiaq
其	qib
凄	qibb
疧	qibm
鬐	qibn
蜞	qic
蛴	qicb
蟣	qicm
蠐	qicn
蚑	qico
蚚	qicp
蚔	qicq
軝	qicr
蜝	qics
螧	qict
螇	qicu
蟿	qicv
奇	qid
契	qidb
豈	qidm
剘	qidn
汽	qie
泣	qieb
漆	qiec
淇	qied
沏	qiee
汔	qief
淒	qiem
亝	qien
洓	qieo
済	qiep
湆	qieq
湇	qier
滊	qies
濝	qiet
旗	qif
绮	qifb
缉	qifc
綦	qifd
緝	qifm
綺	qifn
邔	qifo
郪	qifp
旂	qifq
陭	qifr
隑	qifs
紪	qift
綨	qifu
緀	qifv
綥	qifw
緕	qifx
鄿	qify
罊	qifz
弃	qig
戚	qigb
鬾	qigm
鬿	qign
魌	qigo
魕	qigp
鼜	qigq
七	qih
稽	qihb
亟	qihc
丌	qihd
亓	qihe
炁	qihm
焏	qihn
稘	qiho
棋	qii
栖	qiib
杞	qiic
柒	qiid
槭	qiie
桤	qiif
棲	qiim
棄	qiin
榿	qiio
栔	qiip
梩	qiiq
桼	qiir
棊	qiis
棨	qiit
櫀	qiiu
檱	qiiv
帺	qijm
釮	qijn
锜	qijo
觭	qijp
錡	qijq
鏚	qijr
鐑	qijs
袳	qikm
褀	qikn
褄	qiko
簯	qikp
簱	qikq
籏	qikr
期	qil
麒	qilb
脐	qilc
耆	qild
臍	qilm
肐	qiln
肵	qilo
竒	qilp
竐	qilq
朞	qilr
麡	qils
骑	qim
骐	qimb
騎	qimm
騏	qimn
盀	qimo
盵	qimp
粸	qimq
闙	qimr
騹	qims
妻	qin
娸	qinm
婍	qinn
鵸	qino
鶈	qinp
鶀	qinq
器	qio
启	qiob
嘁	qioc
啟	qiom
呚	qion
呇	qioo
呮	qiop
咠	qioq
唘	qior
唭	qios
啔	qiot
啓	qiou
喰	qiov
噐	qiow
砌	qip
碛	qipb
磧	qipm
矵	qipn
碁	qipo
碕	qipp
毄	qipq
碶	qipr
磎	qips
磩	qipt
磜	qipu
礘	qipv
气	qiq
齐	qiqb
欺	qiqc
欹	qiqd
氣	qiqm
齊	qiqn
気	qiqo
欫	qiqp
猉	qiqq
玂	qiqr
晵	qirm
暣	qirn
霋	qiro
岂	qis
祺	qisb
祈	qisc
崎	qisd
祁	qise
岐	qisf
屺	qisg
岓	qism
祇	qisn
嵜	qiso
禥	qisp
禨	qisq
畦	qit
圻	qitb
畁	qitm
埼	qitn
墄	qito
葺	qiu
萋	qiub
蕲	qiuc
荠	qiud
萁	qiue
芪	qiuf
芑	qiug
薺	qium
蘄	qiun
芞	qiuo
萕	qiup
藄	qiuq
藒	qiur
企	qiv
乞	qivb
俟	qivc
倛	qivm
傶	qivn
僛	qivo
琪	qiw
琦	qiwb
玘	qiwm
斉	qiwn
斊	qiwo
敧	qiwp
甈	qiwq
璂	qiwr
憩	qix
忔	qixm
忯	qixn
恓	qixo
悽	qixp
夡	qixq
愒	qixr
愭	qixs
慽	qixt
慼	qixu
憇	qixv
懠	qixw
鳍	qiy
颀	qiyb
讫	qiyc
訖	qiym
頎	qiyn
鰭	qiyo
諆	qiyp
諬	qiyq
鲯	qiyr
鯕	qiys
起	qiz
歧	qizb
蹊	qizc
迄	qizd
迉	qizm
跂	qizn
攲	qizo
趞	qizp
踑	qizq
踦	qizr
艩	qizs
躩	qizt
搴	qja
掮	qjab
扦	qjac
扲	qjam
拑	qjan
拪	qjao
挳	qjap
掅	qjaq
揵	qjar
揃	qjas
掔	qjat
摼	qjau
撁	qjav
撍	qjaw
攑	qjax
攐	qjay
攓	qjaz
褰	qjb
皘	qjbm
鬝	qjbn
鬜	qjbo
臤	qjcm
蚈	qjcn
蚙	qjco
軡	qjcp
蜸	qjcq
輤	qjcr
厱	qjcs
前	qjd
刋	qjdm
浅	qje
潜	qjeb
淺	qjem
潛	qjen
汘	qjeo
汧	qjep
濳	qjeq
灊	qjer
纤	qjf
阡	qjfb
缱	qjfc
繾	qjfm
綪	qjfn
縴	qjfo
谸	qjgm
靬	qjgn
韆	qjgo
黔	qjh
虔	qjhb
炶	qjhm
煔	qjhn
黚	qjho
椠	qji
槧	qjim
杄	qjin
棈	qjio
榩	qjip
槏	qjiq
橬	qjir
檶	qjis
櫏	qjit
钱	qjj
钳	qjjb
铅	qjjc
钎	qjjd
钤	qjje
鉗	qjjm
鉛	qjjn
錢	qjjo
鈐	qjjp
釺	qjjq
鈆	qjjr
銭	qjjs
鎆	qjjt
鏲	qjju
鑓	qjjv
鐱	qjjw
鑯	qjjx
签	qjk
箝	qjkb
凵	qjkc
簽	qjkm
兛	qjkn
箞	qjko
篏	qjkp
篟	qjkq
籖	qjkr
籤	qjks
肷	qjl
膁	qjlm
竏	qjln
骞	qjm
騫	qjmm
粁	qjmn
馯	qjmo
騝	qjmp
騚	qjmq
牵	qjn
犍	qjnb
牽	qjnm
鶼	qjnn
奷	qjno
婜	qjnp
媊	qjnq
鹐	qjnr
鳽	qjns
嬱	qjnt
鵮	qjnu
孅	qjnv
唊	qjom
嗛	qjon
千	qjp
磏	qjpm
欠	qjq
歉	qjqb
欦	qjqm
欿	qjqn
歁	qjqo
朁	qjrm
嵌	qjs
岍	qjsb
岒	qjsm
嵰	qjsn
堑	qjt
塹	qjtm
圲	qjtn
圱	qjto
墘	qjtp
壍	qjtq
茜	qju
芊	qjub
荨	qjuc
芡	qjud
蕁	qjum
茾	qjun
葥	qjuo
蒨	qjup
蔳	qjuq
乾	qjv
倩	qjvb
佥	qjvc
仟	qjvd
僉	qjvm
伣	qjvn
仱	qjvo
乹	qjvp
俔	qjvq
偂	qjvr
亁	qjvs
傔	qjvt
儙	qjvu
瓩	qjwm
玪	qjwn
悭	qjx
愆	qjxb
慊	qjxc
慳	qjxm
忴	qjxn
悓	qjxo
谦	qjy
谴	qjyb
謙	qjym
譴	qjyn
諐	qjyo
羬	qjyp
顅	qjyq
鰬	qjyr
鰜	qjys
迁	qjz
遣	qjzb
遷	qjzm
歬	qjzn
孯	qjzo
雃	qjzp
宭	qkbm
帬	qkjm
裙	qkk
裠	qkkm
箘	qkkn
麇	qkl
麕	qklm
歏	qkqm
峮	qksm
囷	qkwm
群	qky
羣	qkym
逡	qkz
夋	qkzm
踆	qkzn
撬	qma
摮	qmam
撽	qman
癄	qmbm
蟜	qmcm
削	qmd
劁	qmdb
潐	qmem
缲	qmf
繰	qmfm
陗	qmfn
郻	qmfo
鄡	qmfp
鄥	qmfq
繑	qmfr
巧	qmg
敲	qmgb
鞘	qmgc
鞒	qmgd
鞽	qmgm
髚	qmgn
骹	qmgo
鞩	qmgp
髜	qmgq
丂	qmhm
燆	qmhn
燋	qmho
桥	qmi
樵	qmib
橇	qmic
橋	qmim
槗	qmin
橾	qmio
櫵	qmip
锹	qmj
鍬	qmjm
帩	qmjn
釥	qmjo
幓	qmjp
幧	qmjq
鍫	qmjr
鏒	qmjs
鐈	qmjt
鐰	qmju
箾	qmkm
勪	qmlm
瞧	qmm
睄	qmmm
嫶	qmnm
犞	qmnn
喬	qmom
喿	qmon
嘺	qmoo
噭	qmop
乔	qmp
硗	qmpb
殼	qmpm
磽	qmpn
殻	qmpo
硚	qmpp
毃	qmpq
磝	qmpr
碻	qmps
礄	qmpt
礉	qmpu
峭	qms
壳	qmsb
峤	qmsc
嶠	qmsm
嵪	qmsn
墝	qmtm
墧	qmtn
墽	qmto
荞	qmu
蕎	qmum
荍	qmun
菬	qmuo
藮	qmup
侨	qmv
俏	qmvb
僑	qmvm
偢	qmvn
僺	qmvo
韒	qmwm
悄	qmx
窍	qmxb
憔	qmxc
愀	qmxd
竅	qmxm
翘	qmy
诮	qmyb
谯	qmyc
翹	qmym
誚	qmyn
譙	qmyo
頝	qmyp
譑	qmyq
顦	qmyr
跷	qmz
雀	qmzb
蹺	qmzm
踍	qmzn
趬	qmzo
趫	qmzp
蹻	qmzq
躈	qmzr
扏	qnam
捄	qnan
搝	qnao
鼽	qnb
赇	qnbb
賕	qnbm
虬	qnc
蚯	qncb
蝤	qncc
虯	qncm
蛷	qncn
蝵	qnco
蟗	qncp
蠤	qncq
殏	qndm
求	qne
湫	qneb
泅	qnec
汓	qnem
浗	qnen
湭	qneo
渞	qnep
湬	qneq
邱	qnf
紌	qnfm
絿	qnfn
緧	qnfo
巯	qng
龟	qngb
龜	qngm
巰	qngn
鞦	qngo
鞧	qngp
龝	qngq
秋	qnh
丠	qnhm
秌	qnhn
煪	qnho
穐	qnhp
楸	qni
朹	qnim
梂	qnin
橚	qnio
釓	qnjm
觓	qnjn
釚	qnjo
釻	qnjp
觩	qnjq
銶	qnjr
裘	qnk
篍	qnkm
肍	qnlm
糗	qnm
毬	qnmm
盚	qnmn
牫	qnnm
媝	qnnn
鹙	qnno
鶖	qnnp
叴	qnom
唒	qnon
丘	qnp
皳	qnpm
酋	qnq
犰	qnqb
醔	qnqm
厹	qnsm
崷	qnsn
坵	qntm
塸	qntn
芁	qnum
莍	qnun
萩	qnuo
蓲	qnup
蘒	qnuq
仇	qnv
俅	qnvb
球	qnw
囚	qnwb
玌	qnwm
璆	qnwn
恘	qnxm
恷	qnxn
鳅	qny
鰍	qnym
讎	qnyn
訄	qnyo
訅	qnyp
頄	qnyq
鮂	qnyr
鯄	qnys
鰌	qnyt
鰽	qnyu
讐	qnyv
遒	qnz
逑	qnzb
逎	qnzm
趥	qnzn
抢	qqa
搶	qqam
摤	qqan
摪	qqao
羌	qqb
蜣	qqc
將	qqcm
溬	qqem
漒	qqen
繈	qqfm
繦	qqfn
强	qqg
戗	qqgb
戕	qqgc
強	qqgm
戧	qqgn
廧	qqgo
彊	qqgp
炝	qqh
熗	qqhm
枪	qqi
樯	qqib
槍	qqim
檣	qqin
椌	qqio
锵	qqj
镪	qqjb
锖	qqjc
錆	qqjm
鏘	qqjn
鏹	qqjo
斨	qqjp
鎗	qqjq
襁	qqk
篬	qqkm
腔	qql
嫱	qqn
嬙	qqnm
鶬	qqnn
呛	qqo
嗆	qqom
唴	qqon
啌	qqoo
嗴	qqop
将	qqp
矼	qqpm
牄	qqpn
牆	qqpo
猐	qqqm
獇	qqqn
嶈	qqsm
墙	qqt
墻	qqtm
墏	qqtn
蔷	qqu
薔	qqum
蔃	qqun
蘠	qquo
玱	qqwm
瑲	qqwn
羟	qqy
羥	qqym
羗	qqyn
羫	qqyo
謒	qqyp
羻	qqyq
跄	qqz
蹌	qqzm
蹡	qqzn
艢	qqzo
拳	qra
捲	qram
搼	qran
痊	qrb
鬈	qrbb
蜷	qrc
辁	qrcb
輇	qrcm
齤	qrcn
蠸	qrco
券	qrd
奍	qrdm
泉	qre
汱	qrem
洤	qren
湶	qreo
灥	qrep
绻	qrf
綣	qrfm
絟	qrfn
縓	qrfo
酄	qrfp
弮	qrgm
烇	qrhm
权	qri
權	qrim
棬	qrin
椦	qrio
楾	qrip
槫	qriq
権	qrir
铨	qrj
銓	qrjm
巻	qrjn
觠	qrjo
鐉	qrjp
筌	qrk
箞	qrkm
劝	qrl
勸	qrlm
腃	qrln
勧	qrlo
駩	qrmm
闎	qrmn
騡	qrmo
矔	qrmp
姾	qrnm
牷	qrnn
牶	qrno
婘	qrnp
犈	qrnq
孉	qrnr
啳	qrom
硂	qrpm
犬	qrq
犭	qrqb
醛	qrqc
狋	qrqm
峑	qrsm
巏	qrsn
畎	qrt
埢	qrtm
荃	qru
葲	qrum
虇	qrun
全	qrv
佺	qrvm
圈	qrw
圏	qrwm
瑔	qrwn
韏	qrwo
悛	qrx
恮	qrxm
惓	qrxn
诠	qry
颧	qryb
顴	qrym
詮	qryn
犮	qryo
鳈	qryp
鰁	qryq
跧	qrzm
踡	qrzn
宆	qsbm
蛩	qsc
蛬	qscm
邛	qsf
煢	qshm
焭	qshn
焪	qsho
熍	qshp
桏	qsim
橩	qsin
銎	qsj
卭	qsjm
筇	qsk
笻	qskm
睘	qsmm
瞏	qsmn
嬛	qsnm
茕	qsu
藑	qsum
藭	qsun
儝	qsvm
琼	qsw
瓊	qswm
琁	qswn
璚	qswo
瓗	qswp
穷	qsx
穹	qsxb
窮	qsxm
惸	qsxn
憌	qsxo
竆	qsxp
跫	qsz
赹	qszm
舼	qszn
挈	qta
癿	qtbm
厒	qtcm
蛪	qtcn
蛣	qtco
切	qtd
洯	qtem
淁	qten
郄	qtf
匧	qtfm
緁	qtfn
聺	qtfo
且	qth
稧	qthm
穕	qthn
栔	qtim
椄	qtin
锲	qtj
鍥	qtjm
帹	qtjn
鐑	qtjo
箧	qtk
篋	qtkm
笡	qtkn
籡	qtko
妾	qtn
嗛	qtom
猰	qtqm
朅	qtrm
茄	qtu
苆	qtum
藒	qtun
伽	qtv
倢	qtvm
窃	qtx
怯	qtxb
惬	qtxc
慊	qtxd
竊	qtxm
愜	qtxn
悏	qtxo
鯜	qtym
趄	qtz
疌	qtzm
跙	qtzn
踥	qtzo
抾	quam
癯	qub
髷	qubm
蛆	quc
蛐	qucb
衢	qucc
蠼	qucd
龋	quce
齲	qucm
衐	qucn
蚼	quco
軥	qucp
蝺	qucq
螶	qucr
蟝	qucs
忂	quct
蠷	qucu
刞	qudm
浀	quem
淭	quen
灈	queo
区	quf
區	qufm
匤	qufn
阹	qufo
郥	qufp
紶	qufq
絇	qufr
匷	qufs
戵	qugm
黢	quh
焌	quhm
煀	quhn
爠	quho
渠	qui
欋	quim
欔	quin
觑	quj
覷	qujm
斪	qujn
覰	qujo
覻	qujp
鐻	qujq
鑺	qujr
袪	qukm
筁	qukn
籧	quko
曲	qul
朐	qulb
劬	qulc
胠	qulm
胊	quln
竘	qulo
耝	qulp
脥	qulq
竬	qulr
臞	quls
驱	qum
麴	qumb
阒	qumc
氍	qumd
驅	qumm
麯	qumn
闃	qumo
粬	qump
駆	qumq
麹	qumr
駈	qums
閴	qumt
麮	qumu
鼁	qumv
娶	qun
鸲	qunb
鴝	qunm
鶌	qunn
鸜	quno
呿	quom
唟	quon
屈	qup
磲	qupb
欪	quqm
去	qus
躯	qusb
岖	qusc
祛	qusd
彡	quse
軀	qusm
嶇	qusn
厺	quso
岴	qusp
鼩	qusq
坥	qutm
蕖	quu
蘧	quub
苣	quuc
菃	quum
葋	quun
佢	quvm
佉	quvn
伹	quvo
璩	quw
璖	quwm
敺	quwn
憈	quxm
取	quy
诎	quyb
詘	quym
翑	quyn
詓	quyo
誳	quyp
魼	quyq
鮈	quyr
翵	quys
鰸	quyt
鱋	quyu
趣	quz
趋	quzb
瞿	quzc
趨	quzm
迲	quzn
趍	quzo
跼	quzp
趜	quzq
躣	quzr
掐	qwa
抲	qwam
拤	qwan
揢	qwao
擖	qwap
冾	qwbm
夹	qwd
殎	qwdm
洽	qwe
匼	qwfm
髂	qwg
鞐	qwgm
帢	qwjm
袷	qwk
卡	qwl
胢	qwlm
硈	qwpm
磍	qwpn
酠	qwqm
峠	qwsm
圶	qwtm
葜	qwu
恰	qwx
愘	qwxm
鮚	qwym
跒	qwzm
擒	qxa
揿	qxab
撳	qxam
扲	qxan
抋	qxao
捦	qxap
搇	qxaq
寝	qxb
寢	qxbm
寑	qxbn
寖	qxbo
瘽	qxbp
寴	qxbq
螓	qxc
蚙	qxcm
螼	qxcn
蠄	qxco
沁	qxe
溱	qxeb
澿	qxem
瀙	qxen
耹	qxfm
綅	qxfn
廑	qxg
庈	qxgm
靲	qxgn
秦	qxh
檎	qxi
櫬	qxim
梫	qxin
钦	qxj
锓	qxjb
親	qxjm
鋟	qxjn
鈙	qxjo
鈫	qxjp
斳	qxjq
衾	qxk
笉	qxkm
亲	qxl
勤	qxlb
肣	qxlm
矜	qxm
矝	qxmm
骎	qxmn
駸	qxmo
媇	qxnm
嫀	qxnn
鳹	qxno
鵭	qxnp
噙	qxo
嗪	qxob
吣	qxoc
唚	qxom
吢	qxon
欽	qxqm
昑	qxrm
嵚	qxsm
嵰	qxsn
嶜	qxso
嶔	qxsp
坅	qxtm
埁	qxtn
埐	qxto
墐	qxtp
芹	qxu
芩	qxub
蘄	qxum
菦	qxun
菣	qxuo
菳	qxup
藽	qxuq
侵	qxv
禽	qxvb
儭	qxvm
琴	qxw
珡	qxwm
琹	qxwn
覃	qxx
忴	qxxm
慬	qxxn
懄	qxxo
懃	qxxp
頜	qxym
誛	qxyn
顉	qxyo
鮼	qxyp
赾	qxzm
雂	qxzn
擎	qya
掅	qyam
擏	qyan
凊	qybm
寈	qybn
轻	qyc
蜻	qycb
輕	qycm
軽	qycn
剠	qydm
殑	qydn
清	qye
淸	qyem
渹	qyen
漀	qyeo
濪	qyep
罄	qyf
綮	qyfb
郬	qyfm
綪	qyfn
庆	qyg
庼	qygm
廎	qygn
黥	qyh
檠	qyi
檾	qyim
棾	qyin
樈	qyio
櫦	qyip
卿	qyj
親	qyjm
錆	qyjn
鑋	qyjo
箐	qyk
亲	qyl
勍	qylm
啨	qyom
磬	qyp
殸	qypm
硘	qypn
硜	qypo
碃	qypp
青	qyq
氢	qyqb
氰	qyqc
氫	qyqm
靑	qyqn
靘	qyqo
晴	qyr
暒	qyrm
甠	qysm
埥	qytm
苘	qyu
葝	qyum
倾	qyv
傾	qyvm
儬	qyvn
圊	qyw
情	qyx
慶	qyxm
夝	qyxn
请	qyy
顷	qyyb
謦	qyyc
鲭	qyyd
頃	qyym
請	qyyn
鯖	qyyo
纃	qzfz
罖	rasm
扰	rca
擾	rcam
绕	rcf
繞	rcfm
隢	rcfn
穘	rchm
桡	rci
橈	rcim
襓	rckm
娆	rcn
嬈	rcnm
犪	rcnn
饶	rcs
饒	rcsm
荛	rcu
蕘	rcum
遶	rczm
捼	ream
渃	reem
热	reh
熱	rehm
喏	reo
惹	rex
揉	rfa
宍	rfbm
髳	rfbn
蝚	rfcm
輮	rfcn
渘	rfem
鞣	rfg
煣	rfhm
柔	rfi
楺	rfim
鍒	rfjm
脜	rflm
腬	rfln
糅	rfm
粈	rfmm
騥	rfmn
媃	rfnm
鶔	rfnn
肉	rfr
厹	rfsm
禸	rftm
莥	rfum
葇	rfun
瑈	rfwm
韖	rfwn
瓇	rfwo
鰇	rfym
譳	rfyn
蹂	rfz
扨	rgam
轫	rgc
軔	rgcm
刃	rgd
刄	rgdm
涊	rgem
纫	rgf
紉	rgfm
纴	rgfn
紝	rgfo
絍	rgfp
綛	rgfq
靭	rggm
靱	rggn
稔	rgh
秂	rghm
秹	rghn
朲	rgim
杒	rgin
栣	rgio
栠	rgip
梕	rgiq
棯	rgir
釰	rgjm
釼	rgjn
鈓	rgjo
銋	rgjp
衽	rgk
袵	rgkm
肕	rglm
腍	rgln
妊	rgn
牣	rgnm
姙	rgnn
鵀	rgno
壬	rgp
饪	rgs
飪	rgsm
屻	rgsn
祍	rgso
躵	rgsp
餁	rgsq
荏	rgu
葚	rgub
芢	rgum
荵	rgun
菍	rguo
人	rgv
任	rgvb
仁	rgvc
仞	rgvd
亻	rgve
仭	rgvm
韧	rgw
韌	rgwm
忍	rgx
忈	rgxm
忎	rgxn
认	rgy
認	rgym
讱	rgyn
訒	rgyo
魜	rgyp
攘	rha
鬤	rhbm
瀼	rhem
纕	rhfm
瓤	rhg
穰	rhh
穣	rhhm
爙	rhhn
勷	rhlm
嚷	rho
獽	rhqm
禳	rhs
壤	rht
壌	rhtm
蘘	rhum
儴	rhvm
懹	rhxm
让	rhy
讓	rhym
譲	rhyn
躟	rhzm
釰	rijm
釼	rijn
鈤	rijo
衵	rikm
驲	rimm
馹	rimn
氜	riqm
日	rir
囸	riwm
润	rke
潤	rkem
橍	rkim
膶	rklm
闰	rkm
閏	rkmm
閠	rkmn
瞤	rkmo
髯	rlb
髥	rlbm
蚺	rlc
蚦	rlcm
繎	rlfm
然	rlh
燃	rlhb
熯	rlhm
染	rli
橪	rlim
衻	rlkm
袇	rlkn
袡	rlko
肰	rllm
姌	rlnm
媣	rlnn
呥	rlom
嘫	rlon
冉	rlt
冄	rltm
苒	rlu
蒅	rlum
珃	rlwm
挼	roam
捼	roan
撋	roao
渃	roem
鄀	rofm
弱	rog
焫	rohm
爇	rohn
楉	roim
箬	rok
篛	rokm
婼	ronm
鶸	ronn
嵶	rosm
若	rou
蒻	roum
偌	rov
叒	roym
鰙	royn
鰯	royo
撋	rram
软	rrc
軟	rrcm
蝡	rrcn
輭	rrco
耎	rrem
阮	rrf
緛	rrfm
燸	rrhm
檽	rrim
朊	rrl
腝	rrlm
媆	rrnm
碝	rrpm
礝	rrpn
堧	rrtm
壖	rrtn
偄	rrvm
瑌	rrwm
瓀	rrwn
搑	rsam
搈	rsan
容	rsb
宂	rsbm
髶	rsbn
融	rsc
蝾	rscb
蠑	rscm
軵	rscn
螎	rsco
溶	rse
瀜	rsem
绒	rsf
絨	rsfm
縙	rsfn
戎	rsg
熔	rsh
烿	rshm
穁	rshn
穃	rsho
爃	rshp
榕	rsi
榮	rsim
栄	rsin
榵	rsio
槦	rsip
镕	rsjm
鎔	rsjn
褣	rskm
肜	rsl
冗	rsm
毧	rsmm
駥	rsmn
氄	rsmo
媶	rsnm
嫆	rsnn
嬫	rsno
狨	rsq
曧	rsrm
嵘	rss
嶸	rssm
峵	rssn
嵤	rsso
坈	rstm
荣	rsu
蓉	rsub
茸	rsuc
茙	rsum
傇	rsvm
傛	rsvn
瑢	rswm
羢	rsym
扖	ruam
挐	ruan
擩	ruao
辱	ruc
蠕	rucb
蝡	rucm
汝	rue
濡	rueb
溽	ruec
洳	rued
渪	ruem
缛	ruf
縟	rufm
邚	rufn
鄏	rufo
繻	rufp
杁	ruim
桇	ruin
檽	ruio
铷	ruj
銣	rujm
帤	rujn
褥	ruk
襦	rukb
袽	rukm
筎	rukn
肗	rulm
如	run
鳰	runm
媷	runn
鴑	runo
嬬	runp
鴽	runq
嚅	ruo
吺	ruom
嗕	ruon
獳	ruqm
醹	ruqn
入	rur
曘	rurm
嶿	rusm
茹	ruu
蓐	ruub
薷	ruuc
蒘	ruum
蕠	ruun
乳	ruv
儒	ruvb
侞	ruvm
颥	ruy
顬	ruym
鱬	ruyn
孺	ruz
込	ruzm
抐	rvam
兌	rvbm
蚋	rvc
蜹	rvcm
兊	rvem
汭	rven
緌	rvfm
繠	rvfn
枘	rvi
桵	rvim
橤	rvin
锐	rvj
銳	rvjm
鋭	rvjn
鏸	rvjo
笍	rvkm
睿	rvm
甤	rvsm
壡	rvtm
蕊	rvu
芮	rvub
蕤	rvuc
苼	rvum
蕋	rvun
蘃	rvuo
蘂	rvup
瑞	rvw
惢	rvxm
叡	rvym
扔	rza
陾	rzfm
礽	rzsm
芿	rzum
仍	rzv
辸	rzzm
撒	saa
挲	saab
挱	saam
摋	saan
攃	saao
洒	sae
灑	saem
泧	saen
潵	saeo
飒	saf
颯	safm
隡	safn
纚	safo
靸	sagm
鞈	sagn
卅	sah
櫒	saim
钑	sajm
鈒	sajn
鏾	sajo
脎	sal
馺	samm
萨	sau
薩	saum
蕯	saun
仨	sav
訯	saym
躠	sazm
扫	sca
搔	scab
掃	scam
掻	scan
瘙	scb
螦	sccm
溞	scem
缫	scf
缲	scfb
繅	scfm
繰	scfn
鄵	scfo
颾	scfp
髞	scgm
鐰	scjm
臊	scl
骚	scm
騷	scmm
氉	scmn
騒	scmo
矂	scmp
嫂	scn
埽	sct
慅	scxm
懆	scxn
鳋	scy
鰠	scym
鱢	scyn
揌	sdam
赛	sdb
賽	sdbm
簺	sdkm
腮	sdl
毢	sdmm
毸	sdmn
噻	sdo
嗮	sdom
嘥	sdon
塞	sdt
僿	sdvm
愢	sdxm
鳃	sdy
鰓	sdym
顋	sdyn
拺	seam
摵	sean
擌	seao
瘷	sebm
轖	secm
涩	see
澀	seem
洓	seen
渋	seeo
澁	seep
濏	seeq
濇	seer
瀒	sees
繬	sefm
飋	sefn
廧	segm
穑	seh
穡	sehm
穯	sehn
栜	seim
铯	sej
鉍	sejm
銫	sejn
鎍	sejo
鏼	sejp
粣	semm
閪	semn
闟	semo
嗇	seom
雭	serm
色	ses
啬	sesb
塞	set
薔	seum
僿	sevm
瑟	sew
琗	sewm
璱	sewn
懎	sexm
譅	seym
鱪	seyn
歮	sezm
歰	sezn
搜	sfa
擞	sfab
擻	sfam
捒	sfan
捜	sfao
摉	sfap
摗	sfaq
撨	sfar
凁	sfbm
瘶	sfbn
螋	sfc
溲	sfe
飕	sff
颼	sffm
鄋	sffn
颾	sffo
廋	sfgm
廀	sfgn
棷	sfim
櫢	sfin
锼	sfj
鎪	sfjm
鏉	sfjn
籔	sfkm
瞍	sfm
騪	sfmm
嗽	sfo
嗖	sfob
嗾	sfoc
欶	sfqm
獀	sfqn
醙	sfqo
馊	sfs
餿	sfsm
薮	sfu
藪	sfum
蓃	sfun
蒐	sfuo
傁	sfvm
叟	sfy
叜	sfym
艘	sfz
森	sgi
椮	sgim
槮	sgin
襂	sgkm
搡	sha
桑	shi
桒	shim
槡	shin
鎟	shjm
褬	shkm
嗓	sho
磉	shp
丧	shs
喪	shsm
颡	shy
顙	shym
撕	sia
凘	sibm
寺	sic
厮	sicb
蛳	sicc
螄	sicm
厠	sicn
蜤	sico
蟴	sicp
蟖	sicq
死	sid
汜	sie
泗	sieb
兕	siec
澌	sied
亖	siem
泤	sien
泀	sieo
洠	siep
洍	sieq
涘	sier
瀃	sies
糸	sif
缌	sifb
纟	sifc
絲	sifm
緦	sifn
糹	sifo
飔	sifp
颸	sifq
廝	sigm
丝	sih
私	sihb
虒	sihm
燍	sihn
杫	siim
柶	siin
枱	siio
梩	siip
楒	siiq
榹	siir
斯	sij
锶	sijb
鍶	sijm
釲	sijn
覗	sijo
鈻	sijp
鉰	sijq
鈶	sijr
銉	sijs
銯	sijt
鋖	siju
鐁	sijv
笥	sik
簛	sikm
耜	sil
耛	silm
竢	siln
驷	sim
駟	simm
騃	simn
騦	simo
姒	sin
鸶	sinb
鷥	sinm
牭	sinn
娰	sino
媤	sinp
司	sio
嘶	siob
嗣	sioc
咝	siod
噝	siom
磃	sipm
饲	sis
祀	sisb
巳	sisc
食	sisd
厶	sise
飼	sism
飴	sisn
厼	siso
飤	sisp
禗	sisq
罳	sisr
禠	siss
禩	sist
鼶	sisu
蕬	sium
蕼	siun
似	siv
伺	sivb
俟	sivc
佀	sivm
価	sivn
俬	sivo
偲	sivp
傂	sivq
儩	sivr
四	siw
思	six
恖	sixm
愢	sixn
肆	siy
肂	siym
鯣	siyn
孠	sizm
貄	sizn
损	ska
損	skam
扻	skan
搎	skao
摌	skap
潠	skem
榫	ski
槂	skim
鎨	skjm
笋	skk
筍	skkm
箰	skkn
簨	skko
鶽	sknm
喰	skom
狲	skq
猻	skqm
飧	sks
飱	sksm
荪	sku
蓀	skum
蕵	skun
薞	skuo
孙	skz
隼	skzb
孫	skzm
鬖	slbm
氵	sle
潵	slem
繖	slfm
三	slh
帴	sljm
厁	sljn
鏒	sljo
鏾	sljp
糁	slm
毵	slmb
毿	slmm
糝	slmn
閐	slmo
毶	slmp
糂	slmq
糤	slmr
糣	slms
犙	slnm
叁	sls
馓	slsb
彡	slsc
參	slsm
饊	slsn
壭	slso
叄	slsp
叅	slsq
伞	slv
仨	slvb
傘	slvm
仐	slvn
俕	slvo
散	slw
弎	slym
挲	soa
挱	soam
摍	soan
蜶	socm
溹	soem
溑	soen
索	sof
缩	sofb
縮	sofm
縒	sofn
所	soh
梭	soi
桫	soib
锁	soj
鎖	sojm
鎈	sojn
鎍	sojo
鎻	sojp
鏁	sojq
褨	sokm
簑	sokn
簔	soko
睃	som
娑	son
嫅	sonm
嗦	soo
唆	soob
唢	sooc
嗍	sood
嗩	soom
獕	soqm
暛	sorm
靃	sorn
蓑	sou
莎	soub
莏	soum
葰	soun
傞	sovm
琐	sow
瑣	sowm
琑	sown
璅	sowo
惢	soxm
羧	soy
魦	soym
鮻	soyn
逤	sozm
趖	sozn
痠	srbm
匴	srfm
算	srk
笇	srkm
筭	srkn
篹	srko
酸	srq
狻	srqb
祘	srsm
蒜	sru
捒	ssam
揔	ssan
摗	ssao
宋	ssb
凇	ssbb
鬆	ssbm
蜙	sscm
淞	sse
漎	ssem
濍	ssen
耸	ssf
聳	ssfm
庺	ssgm
松	ssi
枩	ssim
枀	ssin
柗	ssio
梥	ssip
棇	ssiq
楤	ssir
檧	ssis
鍶	ssjm
鎹	ssjn
竦	ssl
駷	ssmm
娀	ssnm
吅	ssom
硹	sspm
嵩	sss
崧	sssb
嵷	sssm
餸	sssn
菘	ssu
蘴	ssum
倯	ssvm
傱	ssvn
悚	ssx
怂	ssxb
忪	ssxc
慫	ssxm
愡	ssxn
愯	ssxo
憁	ssxp
憽	ssxq
颂	ssy
诵	ssyb
讼	ssyc
訟	ssym
頌	ssyn
誦	ssyo
送	ssz
摵	suam
宿	sub
殐	sudm
溯	sue
涑	sueb
泝	suem
洬	suen
溸	sueo
潥	suep
潚	sueq
素	suf
缩	sufb
縮	sufm
縤	sufn
穌	suhm
稡	suhn
梀	suim
棴	suin
榡	suio
樕	suip
樎	suiq
橚	suir
櫯	suis
夙	suj
觫	sujb
鋉	sujm
簌	suk
膆	sulm
粟	sum
粛	summ
骕	sumn
驌	sumo
鹔	sunm
嫊	sunn
鷫	suno
嗉	suo
囌	suom
碿	supm
酥	suq
甦	susm
餗	susn
塑	sut
圱	sutm
埣	sutn
塐	suto
苏	suu
蔌	suub
蘇	suum
莤	suun
藗	suuo
蘓	suup
俗	suv
僳	suvb
傃	suvm
玊	suwm
珟	suwn
璛	suwo
愫	sux
窣	suxm
愬	suxn
憟	suxo
诉	suy
肃	suyb
稣	suyc
谡	suyd
訴	suym
肅	suyn
謖	suyo
鯂	suyp
鱐	suyq
速	suz
遡	suzm
趚	suzn
遬	suzo
蹜	suzp
挼	svam
賥	svbm
虽	svc
濉	sve
亗	svem
浽	sven
滖	sveo
澻	svep
瀡	sveq
随	svf
隋	svfb
隧	svfc
绥	svfd
綏	svfm
隨	svfn
陏	svfo
缞	svfp
縗	svfq
繀	svfr
旞	svfs
繐	svft
繸	svfu
髓	svg
鞖	svgm
髄	svgn
穗	svh
燧	svhb
煫	svhm
穂	svhn
熣	svho
穟	svhp
檖	svim
鐆	svjm
鏸	svjn
鐩	svjo
襚	svkm
脺	svlm
膸	svln
睢	svm
眭	svmb
粋	svmm
睟	svmn
毸	svmo
娞	svnm
嬘	svnn
哸	svom
嗺	svon
碎	svp
尿	svpb
砕	svpm
岁	svs
祟	svsb
嵗	svsm
禭	svsn
埣	svtm
荽	svu
芕	svum
荾	svun
倠	svvm
璲	svwm
瓍	svwn
韢	svwo
谇	svy
誶	svym
譢	svyn
遂	svz
邃	svzb
歲	svzm
雖	svzn
夊	svzo
遀	svzp
歳	svzq
鬙	szbm
僧	szv
拓	taa
挞	taab
撻	taam
搨	taan
撘	taao
它	tab
沓	tae
漯	taeb
溻	taec
涾	taem
溚	taen
澾	taeo
濌	taep
鞈	tagm
鞜	tagn
鞳	tago
榻	tai
榙	taim
橽	tain
铊	taj
鉈	tajm
錔	tajn
鎑	tajo
鎉	tajp
褟	takm
襨	takn
闼	tam
闥	tamm
粏	tamn
阘	tamo
毾	tamp
闒	tamq
闟	tamr
她	tan
牠	tanm
嗒	tao
咜	taom
嚃	taon
嚺	taoo
獭	taq
獺	taqm
狧	taqn
祂	tasm
崉	tasn
禢	taso
塔	tat
塌	tatb
墖	tatm
荅	taum
他	tav
侤	tavm
傝	tavn
鳎	tay
鰨	taym
誻	tayn
鮙	tayo
譶	tayp
踏	taz
蹋	tazb
遢	tazc
趿	tazd
逹	tazm
遝	tazn
蹹	tazo
躢	tazp
掏	tca
抭	tcam
搯	tcan
匋	tcbm
蜪	tccm
轁	tccn
套	tcd
丶	tcdb
夲	tcdm
夵	tcdn
涛	tce
滔	tceb
淘	tcec
洮	tced
濤	tcem
涭	tcen
陶	tcf
绦	tcfb
绹	tcfm
絛	tcfn
綯	tcfo
縧	tcfp
縚	tcfq
鼗	tcg
弢	tcgm
鞀	tcgn
鞉	tcgo
鞱	tcgp
焘	tch
燾	tchm
桃	tci
梼	tcim
槄	tcin
檮	tcio
幍	tcjm
錭	tcjn
鋾	tcjo
裪	tckm
駣	tcmm
騊	tcmn
嫍	tcnm
叨	tco
啕	tcob
咷	tcom
醄	tcqm
饕	tcs
祹	tcsm
飸	tcsn
饀	tcso
萄	tcu
韬	tcw
韜	tcwm
瑫	tcwn
慆	tcxm
讨	tcy
討	tcym
詜	tcyn
謟	tcyo
逃	tcz
迯	tczm
抬	tda
擡	tdam
太	tdd
大	tddb
夳	tddm
冭	tddn
奤	tddo
泰	tde
汰	tdeb
汏	tdem
汱	tden
溙	tdeo
邰	tdf
颱	tdfm
炱	tdh
炲	tdhm
燤	tdhn
枱	tdim
檯	tdin
钛	tdj
鈦	tdjm
鈶	tdjn
箈	tdkm
籉	tdkn
胎	tdl
肽	tdlb
骀	tdm
駘	tdmm
嬯	tdnm
台	tdo
呔	tdob
咍	tdom
酞	tdq
旲	tdrm
坮	tdtm
苔	tdu
薹	tdub
菭	tdum
儓	tdvm
囼	tdwm
珆	tdwn
斄	tdwo
态	tdx
態	tdxm
忕	tdxn
忲	tdxo
鲐	tdy
鮐	tdym
跆	tdz
臺	tdzm
孡	tdzn
舦	tdzo
貸	tebm
貣	tebn
蟘	tecm
铽	tej
鋱	tejm
脦	telm
特	ten
犆	tenm
忑	tex
忒	texb
慝	texc
投	tfa
头	tfd
斢	tfdm
紏	tffm
緰	tffn
骰	tfg
黈	tfhm
钭	tfj
鋀	tfjm
鍮	tfjn
妵	tfnm
媮	tfnn
婾	tfno
飳	tfsm
亠	tft
埱	tftm
蘣	tfum
偷	tfv
偸	tfvm
敨	tfwm
頭	tfym
透	tfz
搪	tha
摥	tham
攩	than
螳	thc
螗	thcb
蝪	thcm
赯	thcn
劏	thdm
汤	the
淌	theb
溏	thec
湯	them
漟	then
漡	theo
灙	thep
鄌	thfm
隚	thfn
鞺	thgm
鼞	thgn
烫	thh
燙	thhm
煻	thhn
爣	thho
棠	thi
樘	thib
榶	thim
橖	thin
欓	thio
镗	thj
帑	thjb
铴	thjc
鏜	thjm
鐋	thjn
镋	thjo
鎲	thjp
鎕	thjq
钂	thjr
篖	thkm
簜	thkn
膛	thl
耥	thlb
膅	thlm
糖	thm
閶	thmm
糃	thmn
糛	thmo
闛	thmp
闣	thmq
矘	thmr
鶶	thnm
唐	tho
啺	thom
嘡	thon
磄	thpm
醣	thq
曭	thrm
躺	ths
嵣	thsm
禟	thsn
餹	thso
饄	thsp
堂	tht
塘	thtb
坣	thtm
蓎	thum
薚	thun
蘯	thuo
倘	thv
傥	thvb
儻	thvm
伖	thvn
偒	thvo
傏	thvp
瑭	thw
惝	thx
愓	thxm
戃	thxn
羰	thy
趟	thz
逿	thzm
踼	thzn
蹚	thzo
提	tia
扌	tiab
挮	tiam
掦	tian
揥	tiao
擿	tiap
髰	tibm
鬀	tibn
鬄	tibo
厗	ticm
徥	ticn
蝭	tico
徲	ticp
剔	tid
剃	tidb
奃	tidm
殢	tidn
涕	tie
洟	tiem
渧	tien
漽	tieo
缇	tif
绨	tifb
綈	tifm
緹	tifn
體	tigm
骵	tign
戻	tihm
稊	tihn
梯	tii
桋	tiim
楴	tiin
锑	tij
銻	tijm
鍗	tijn
裼	tik
笹	tikm
褆	tikn
褅	tiko
籊	tikp
眣	timm
睼	timn
騠	timo
鹈	tin
鵜	tinm
姼	tinn
媞	tino
媂	tinp
鶗	tinq
鶙	tinr
鷈	tins
鷉	tint
鷤	tinu
啼	tio
嚏	tiob
啑	tiom
嗁	tion
嚔	tioo
屉	tip
屜	tipm
屟	tipn
碮	tipo
磃	tipp
醍	tiq
歒	tiqm
替	tir
罤	tism
嵜	tisn
崹	tiso
躰	tisp
禔	tisq
軆	tisr
禵	tiss
荑	tiu
苐	tium
蕛	tiun
薙	tiuo
体	tiv
倜	tivb
俶	tivm
偍	tivn
珶	tiwm
瑅	tiwn
瓋	tiwo
惕	tix
悌	tixb
悐	tixm
惖	tixn
惿	tixo
题	tiy
題	tiym
詆	tiyn
鳀	tiyo
謕	tiyp
鮷	tiyq
鯷	tiyr
踢	tiz
蹄	tizb
逖	tizc
迖	tizm
逷	tizn
遆	tizo
趧	tizp
蹏	tizq
趯	tizr
掭	tja
捵	tjam
搷	tjan
兲	tjbm
痶	tjbn
賟	tjbo
天	tjd
殄	tjdb
添	tje
沺	tjem
淟	tjen
湉	tjeo
紾	tjfm
緂	tjfn
甜	tjg
甛	tjgm
黇	tjhm
钿	tjj
鈿	tjjm
铦	tjjn
觍	tjjo
銛	tjjp
覥	tjjq
銽	tjjr
錪	tjjs
腆	tjl
胋	tjlm
阗	tjm
靦	tjmm
闐	tjmn
盷	tjmo
睓	tjmp
睼	tjmq
奵	tjnm
婖	tjnn
鴫	tjno
鷏	tjnp
鷆	tjnq
呑	tjom
唺	tjon
屇	tjpm
碵	tjpn
磌	tjpo
靔	tjqm
酟	tjqn
靝	tjqo
晪	tjrm
舔	tjs
舑	tjsm
餂	tjsn
舚	tjso
田	tjt
填	tjtb
畋	tjtc
畑	tjtm
畠	tjtn
塡	tjto
菾	tjum
佃	tjv
倎	tjvm
琠	tjwm
瑱	tjwn
璳	tjwo
恬	tjx
忝	tjxb
悿	tjxm
窴	tjxn
顚	tjym
軘	tkcm
蛌	tkcn
蜳	tkco
氽	tke
涒	tkem
庉	tkgm
屯	tkh
焞	tkhm
黗	tkhn
錪	tkjm
褪	tkk
臀	tkl
豚	tklb
朜	tklm
吞	tko
呑	tkom
啍	tkon
噋	tkoo
暾	tkr
旽	tkrm
霕	tkrn
臋	tkro
饨	tks
飩	tksm
豘	tksn
坉	tktm
畽	tktn
芚	tkum
囤	tkw
瓲	tkwm
忳	tkxm
憞	tkxn
鲀	tkym
魨	tkyn
探	tla
摊	tlab
撣	tlam
攤	tlan
擹	tlao
贪	tlb
瘫	tlbb
痰	tlbc
貪	tlbm
癱	tlbn
賧	tlbo
癉	tlbp
痑	tlbq
潭	tle
滩	tleb
澹	tlec
灘	tlem
湠	tlen
潬	tleo
郯	tlf
緂	tlfm
罈	tlfn
繵	tlfo
罎	tlfp
弹	tlg
彈	tlgm
弾	tlgn
炭	tlh
燂	tlhm
黮	tlhn
檀	tli
榃	tlim
橝	tlin
钽	tlj
锬	tljb
鉭	tljm
錟	tljn
袒	tlk
裧	tlkm
襢	tlkn
毯	tlm
婒	tlnm
叹	tlo
嘆	tlom
啴	tlon
嗿	tloo
嘾	tlop
嘽	tloq
碳	tlp
歎	tlqm
醈	tlqn
醓	tlqo
醰	tlqp
昙	tlr
曇	tlrm
暺	tlrn
舑	tlsm
舕	tlsn
餤	tlso
坦	tlt
坛	tltb
坍	tltc
壇	tltm
埮	tltn
墰	tlto
墵	tltp
壜	tltq
菼	tlum
藫	tlun
倓	tlvm
傝	tlvn
僋	tlvo
儃	tlvp
璮	tlwm
忐	tlx
覃	tlxb
怹	tlxm
惔	tlxn
憛	tlxo
憳	tlxp
憻	tlxq
谈	tly
谭	tlyb
談	tlym
譚	tlyn
顃	tlyo
譠	tlyp
貚	tlzm
挑	tma
髫	tmb
宨	tmbm
蜩	tmc
龆	tmcb
齠	tmcm
斢	tmdm
聎	tmfm
絩	tmfn
庣	tmgm
鞗	tmgn
条	tmi
條	tmim
朷	tmin
樤	tmio
銚	tmjm
覜	tmjn
鋚	tmjo
鎥	tmjp
笤	tmk
朓	tmlm
脁	tmln
眺	tmm
粜	tmmb
糶	tmmm
嬥	tmnm
咷	tmom
旫	tmrm
晀	tmrn
祧	tms
岧	tmsm
岹	tmsn
祒	tmso
苕	tmu
蓧	tmum
芀	tmun
萔	tmuo
蓚	tmup
蓨	tmuq
佻	tmv
儵	tmvm
窕	tmx
恌	tmxm
窱	tmxn
调	tmy
鲦	tmyb
調	tmym
鰷	tmyn
誂	tmyo
鯈	tmyp
跳	tmz
迢	tmzb
趒	tmzm
托	toa
拖	toab
拓	toac
扡	toam
拕	toan
挩	toao
捝	toap
搨	toaq
撱	toar
魄	tob
彵	tocm
蟺	tocn
沱	toe
汑	toem
沰	toen
涶	toeo
陀	tof
阤	tofm
陁	tofn
紽	tofo
庹	tog
椭	toi
橐	toib
柁	toic
柝	toid
橢	toim
杔	toin
杝	toio
楕	toip
槖	toiq
铊	toj
鉈	tojm
鋖	tojn
箨	tok
籜	tokm
袥	tokn
袉	toko
脱	tol
脫	tolm
驼	tom
驮	tomb
鼍	tomc
馱	tomm
駝	tomn
鼉	tomo
毤	tomp
馲	tomq
毻	tomr
駄	toms
駞	tomt
騨	tomu
驒	tomv
驝	tomw
妥	ton
鸵	tonb
鴕	tonm
媠	tonn
嫷	tono
鵎	tonp
唾	too
咃	toom
咜	toon
啴	tooo
嘽	toop
砣	top
乇	topb
砤	topm
碢	topn
酡	toq
狏	toqm
饦	tosm
岮	tosn
飥	toso
嶞	tosp
鼧	tosq
坨	tot
堶	totm
莌	toum
萚	toun
蘀	touo
佗	tov
仛	tovm
侂	tovn
侻	tovo
讬	toym
託	toyn
詑	toyo
魠	toyp
説	toyq
鮀	toyr
鮵	toys
鰖	toyt
跎	toz
跅	tozm
忒	tpx
抟	tra
摶	tram
剸	trdm
湍	tre
湪	trem
漙	tren
煓	trhm
槫	trim
檲	trin
鏄	trjm
褖	trkm
篿	trkn
糰	trmm
鷒	trnm
鷻	trnn
猯	trqm
彖	trs
疃	trt
塼	trtm
畽	trtn
墥	trto
团	trw
團	trwm
団	trwn
圕	trwo
慱	trxm
貒	trzm
捅	tsa
痛	tsb
痌	tsbm
蚒	tscm
衕	tscn
赨	tsco
潼	tse
浵	tsem
湩	tsen
统	tsf
統	tsfm
絧	tsfn
綂	tsfo
庝	tsgm
炵	tshm
烔	tshn
秱	tsho
熥	tshp
燑	tshq
穜	tshr
爞	tshs
桶	tsi
桐	tsib
樋	tsim
橦	tsin
铜	tsj
銅	tsjm
鉖	tsjn
鉵	tsjo
筒	tsk
筩	tskm
童	tsl
勭	tslm
朣	tsln
膧	tslo
瞳	tsm
眮	tsmm
粡	tsmn
氃	tsmo
犝	tsnm
同	tso
嗵	tsob
哃	tsom
砼	tsp
硧	tspm
酮	tsq
狪	tsqm
獞	tsqn
晍	tsrm
曈	tsrn
彤	tss
峒	tssb
峂	tssm
峝	tssn
餇	tsso
垌	tst
茼	tsu
蓪	tsum
佟	tsv
侗	tsvb
僮	tsvc
仝	tsvd
偅	tsvm
囲	tswm
恸	tsx
慟	tsxm
憅	tsxn
詷	tsym
鲖	tsyn
鮦	tsyo
通	tsz
揲	tta
贴	ttb
貼	ttbm
蛈	ttcm
聑	ttfm
铁	ttj
帖	ttjb
鉆	ttjm
鐵	ttjn
鋨	ttjo
鉄	ttjp
銕	ttjq
鐡	ttjr
驖	ttmm
鴩	ttnm
呫	ttom
餮	tts
飻	ttsm
萜	ttu
僣	ttvm
怗	ttxm
惵	ttxn
跕	ttzm
捈	tuam
捸	tuan
揬	tuao
摕	tuap
宊	tubm
凃	tubn
痜	tubo
瘏	tubp
徒	tuc
兔	tud
涂	tue
汢	tuem
兎	tuen
涋	tueo
湥	tuep
潳	tueq
庩	tugm
廜	tugn
秃	tuh
禿	tuhm
稌	tuhn
梌	tuim
檡	tuin
钍	tuj
釷	tujm
鈯	tujn
鋀	tujo
鋵	tujp
鍎	tujq
凸	tuk
筡	tukm
腯	tulm
駼	tumm
鵚	tunm
鵌	tunn
鵵	tuno
鶟	tunp
鷋	tunq
鷵	tunr
吐	tuo
唋	tuom
啚	tuon
屠	tup
酴	tuq
峹	tusm
嵞	tusn
嶀	tuso
鼵	tusp
土	tut
堍	tutb
塗	tutm
圡	tutn
堗	tuto
墿	tutp
荼	tuu
菟	tuub
莵	tuum
葖	tuun
蒤	tuuo
图	tuw
圖	tuwm
図	tuwn
瑹	tuwo
圗	tuwp
突	tux
怢	tuxm
悇	tuxn
馟	tuxo
途	tuz
迌	tuzm
趃	tuzn
跿	tuzo
推	tva
蜕	tvc
蛻	tvcm
聉	tvfm
隤	tvfn
弚	tvgm
骽	tvgn
魋	tvgo
煺	tvh
穨	tvhm
橔	tvim
褪	tvk
腿	tvl
駾	tvmm
騩	tvmn
娧	tvnm
墤	tvtm
蓷	tvum
藬	tvun
蘈	tvuo
俀	tvvm
侻	tvvn
僓	tvvo
忒	tvx
怢	tvxm
颓	tvy
頹	tvym
尵	tvyn
頽	tvyo
頺	tvyp
讉	tvyq
退	tvz
蹆	tvzm
蹪	tvzn
挺	tya
厅	tyc
蜓	tycb
厛	tycm
蝏	tycn
汀	tye
涏	tyem
渟	tyen
濎	tyeo
聽	tyfm
邒	tyfn
綎	tyfo
聤	tyfp
聴	tyfq
聼	tyfr
庭	tyg
廳	tygm
庁	tygn
庍	tygo
鞓	tygp
廰	tygq
烃	tyh
烴	tyhm
烶	tyhn
梃	tyi
桯	tyim
楟	tyin
榳	tyio
铤	tyj
鋌	tyjm
筳	tykm
耓	tylm
脡	tyln
閮	tymm
婷	tyn
娗	tynm
听	tyo
霆	tyr
嵉	tysm
鼮	tysn
亭	tyt
町	tytb
圢	tytm
甼	tytn
莛	tyu
葶	tyub
艼	tyum
停	tyv
侹	tyvm
侱	tyvn
珽	tywm
珵	tywn
忊	tyxm
廷	tyy
颋	tyym
誔	tyyn
頲	tyyo
諪	tyyp
艇	tyz
疼	tzb
痋	tzbm
螣	tzcm
漛	tzem
縢	tzfm
鼟	tzgm
熥	tzhm
幐	tzjm
籐	tzkm
籘	tzkn
腾	tzl
滕	tzlb
膯	tzlm
騰	tzmm
駦	tzmn
驣	tzmo
霯	tzrm
藤	tzu
虅	tzum
儯	tzvm
誊	tzy
謄	tzym
鰧	tzyn
邆	tzzm
扎	uaa
揸	uaab
摣	uaam
扠	uaan
抯	uaao
拃	uaap
挓	uaaq
挿	uaar
揷	uaas
搾	uaat
痄	uab
齄	uabb
齇	uabm
宱	uabn
轧	uac
蚱	uacb
蜡	uacc
軋	uacm
蠟	uacn
齟	uaco
厏	uacp
蚻	uacq
齰	uacr
劄	uadm
奓	uadn
剳	uado
渣	uae
溠	uaem
潳	uaen
紮	uafm
紥	uafn
鞢	uagm
炸	uah
灹	uahm
煠	uahn
栅	uai
札	uaib
榨	uaic
查	uaid
柞	uaie
楂	uaif
柵	uaim
柤	uain
査	uaio
樝	uaip
铡	uaj
鍘	uajm
觰	uajn
箚	uakm
耫	ualm
眨	uam
闸	uamb
閘	uamm
咋	uao
喳	uaob
吒	uaoc
喋	uaod
咤	uaoe
哳	uaof
啑	uaom
喥	uaon
囃	uaoo
乍	uap
砟	uapb
牐	uapm
皶	uapn
皻	uapo
醡	uaqm
霅	uarm
飵	uasm
苲	uaum
蔖	uaun
偞	uavm
偧	uavn
诈	uay
詐	uaym
鰈	uayn
鲊	uayo
鲝	uayp
諎	uayq
鮓	uayr
鮺	uays
譇	uayt
譗	uayu
找	uca
招	ucab
兆	uce
沼	uceb
罀	ucfm
旐	ucfn
照	uch
炤	uchm
燳	uchn
棹	uci
枛	ucim
櫂	ucin
钊	ucj
釗	ucjm
釽	ucjn
鉊	ucjo
鍣	ucjp
笊	uck
箌	uckm
朝	ucl
着	ucm
盄	ucmm
鼌	ucmn
駋	ucmo
瞾	ucmp
鼂	ucmq
妱	ucnm
鳭	ucnn
召	uco
嘲	ucob
啁	ucoc
啅	ucom
皽	ucpm
狣	ucqm
昭	ucr
曌	ucrm
罩	ucs
巶	ucsm
羄	ucsn
垗	uctm
菬	ucum
佋	ucvm
瑵	ucwm
肇	ucy
诏	ucyb
詔	ucym
肁	ucyn
肈	ucyo
鮡	ucyp
謿	ucyq
赵	ucz
爪	uczb
趙	uczm
爫	uczn
摘	uda
择	udab
擇	udam
択	udan
抧	udao
捚	udap
擿	udaq
寨	udb
宅	udbb
瘵	udbc
責	udbm
厇	udcm
厏	udcn
亝	udem
骴	udgm
榸	udim
檡	udin
鉙	udjm
簀	udkm
駘	udmm
粂	udmn
哜	udo
嚌	udom
砦	udp
齋	udqm
债	udv
侧	udvb
側	udvm
債	udvn
斋	udw
斎	udwm
窄	udx
翟	udy
夈	udzm
折	uea
摺	ueab
扸	ueam
摂	uean
搩	ueao
辙	uec
蛰	uecb
辄	uecc
蜇	uecd
赭	uece
螫	uecf
蟄	uecm
轍	uecn
輒	ueco
厇	uecp
虴	uecq
輙	uecr
蟅	uecs
歽	uedm
浙	uee
淛	ueem
聑	uefm
柘	uei
杔	ueim
棏	uein
樜	ueio
锗	uej
鍺	uejm
銸	uejn
褶	uek
袩	uekm
襵	uekn
者	uel
着	uem
籷	uemm
粍	uemn
馲	uemo
鹧	uen
鷓	uenm
嫬	uenn
哲	ueo
囁	ueom
啠	ueon
喆	ueoo
嗻	ueop
嚞	ueoq
磔	uep
乇	uepb
矺	uepm
砓	uepn
晢	uerm
晣	uern
埑	uetm
蔗	ueu
乽	uevm
悊	uexm
慹	uexn
谪	uey
謫	ueym
詟	ueyn
謺	ueyo
鮿	ueyp
讁	ueyq
讋	ueyr
这	uez
遮	uezb
夂	uezc
這	uezm
踷	uezn
掫	ufam
宙	ufb
疛	ufbm
赒	ufbn
賙	ufbo
州	ufc
轴	ufcb
軸	ufcm
辀	ufcn
徟	ufco
輈	ufcp
輖	ufcq
洲	ufe
洀	ufem
淍	ufen
纣	uff
繇	uffb
绉	uffc
紂	uffm
縐	uffn
郮	uffo
紬	uffp
炿	ufhm
烐	ufhn
椆	ufim
帚	ufj
鈾	ufjm
箒	ufjn
銂	ufjo
籀	ufk
籕	ufkm
籒	ufkn
肘	ufl
胄	uflb
胕	uflm
骤	ufm
粥	ufmb
驟	ufmm
粙	ufmn
睭	ufmo
駎	ufmp
駲	ufmq
盩	ufmr
騆	ufms
妯	ufn
鸼	ufnm
婤	ufnn
鵃	ufno
周	ufo
咒	ufob
啁	ufoc
呪	ufom
咮	ufon
喌	ufoo
噣	ufop
嚋	ufoq
皱	ufp
碡	ufpb
皺	ufpm
酎	ufq
昼	ufr
晝	ufrm
晭	ufrn
霌	ufro
矪	ufsm
冑	uftm
荮	ufu
葤	ufum
菷	ufun
薵	ufuo
伷	ufvm
侜	ufvn
僽	ufvo
珘	ufwm
甃	ufwn
诌	ufy
調	ufym
謅	ufyn
诪	ufyo
詋	ufyp
詶	ufyq
翢	ufyr
鯞	ufys
譸	ufyt
舟	ufz
週	ufzm
振	uga
抮	ugam
挋	ugan
揕	ugao
搸	ugap
贞	ugb
赈	ugbb
疹	ugbc
貞	ugbm
賑	ugbn
寊	ugbo
鬒	ugbp
轸	ugc
軫	ugcm
蜄	ugcn
轃	ugco
辴	ugcp
斟	ugd
殝	ugdm
溱	uge
浈	ugeb
湞	ugem
沴	ugen
潧	ugeo
澵	ugep
阵	ugf
缜	ugfb
陣	ugfm
縝	ugfn
纼	ugfo
紖	ugfp
聄	ugfq
紾	ugfr
絼	ugfs
縥	ugft
弫	uggm
稹	ugh
黰	ughm
枕	ugi
桢	ugib
榛	ugic
椹	ugid
楨	ugim
朾	ugin
枮	ugio
栚	ugip
桭	ugiq
槙	ugir
槇	ugis
榐	ugit
樼	ugiu
镇	ugj
针	ugjb
帧	ugjc
針	ugjm
幀	ugjn
鎮	ugjo
帪	ugjp
鈂	ugjq
覙	ugjr
鉁	ugjs
鋴	ugjt
錱	ugju
鍖	ugjv
鍼	ugjw
鎭	ugjx
箴	ugk
袗	ugkm
裖	ugkn
籈	ugko
朕	ugl
胗	uglb
竧	uglm
眕	ugmm
眞	ugmn
眹	ugmo
駗	ugmp
鸩	ugn
鴆	ugnm
姫	ugnn
嫃	ugno
砧	ugp
屒	ugpm
碪	ugpn
酙	ugqm
靕	ugqn
獉	ugqo
震	ugr
昣	ugrm
真	ugs
祯	ugsb
禎	ugsm
禛	ugsn
圳	ugt
畛	ugtb
甽	ugtm
塦	ugtn
塡	ugto
蓁	ugu
萙	ugum
葴	ugun
蒖	uguo
薽	ugup
侦	ugv
偵	ugvm
侲	ugvn
珍	ugw
甄	ugwb
珎	ugwm
瑧	ugwn
瑱	ugwo
敶	ugwp
诊	ugy
診	ugym
誫	ugyn
謓	ugyo
鱵	ugyp
臻	ugz
遉	ugzm
掌	uha
扙	uham
账	uhb
瘴	uhbb
賬	uhbm
痮	uhbn
瘬	uhbo
长	uhc
蟑	uhcb
長	uhcm
兏	uhcn
涨	uhe
漳	uheb
漲	uhem
涱	uhen
障	uhf
鄣	uhfb
张	uhg
張	uhgm
弡	uhgn
鞝	uhgo
丈	uhh
杖	uhi
樟	uhib
帐	uhj
幛	uhjb
帳	uhjm
幥	uhjn
鏱	uhjo
章	uhl
胀	uhlb
脹	uhlm
麞	uhln
粀	uhmm
粻	uhmn
瞕	uhmo
騿	uhmp
嫜	uhn
礃	uhpm
獐	uhq
暲	uhrm
彰	uhs
嶂	uhsb
餦	uhsm
墇	uhtm
蔁	uhum
仗	uhv
仉	uhvb
仧	uhvm
傽	uhvn
璋	uhw
慞	uhxm
鱆	uhym
遧	uhzm
指	uia
执	uiab
掷	uiac
挚	uiad
摭	uiae
摯	uiam
擲	uian
扺	uiao
扻	uiap
抧	uiaq
挃	uiar
捗	uias
搘	uiat
搱	uiau
摕	uiav
摨	uiaw
擳	uiax
擿	uiay
质	uib
贽	uibb
痣	uibc
痔	uibd
質	uibm
贄	uibn
疻	uibo
疷	uibp
貭	uibq
痓	uibr
寘	uibs
瘈	uibt
蜘	uic
徵	uicb
蛭	uicc
轾	uicd
轵	uice
軹	uicm
輊	uicn
厔	uico
蚔	uicp
徏	uicq
徝	uicr
軽	uics
徴	uict
螲	uicu
蟙	uicv
之	uid
制	uidb
殖	uidc
剬	uidm
劕	uidn
豑	uido
治	uie
滞	uieb
汁	uiec
滯	uiem
汥	uien
沚	uieo
汦	uiep
泜	uieq
洔	uier
洷	uies
淽	uiet
淔	uieu
滍	uiev
潌	uiew
漐	uiex
潪	uiey
瀄	uiez
职	uif
织	uifb
纸	uifc
絷	uifd
陟	uife
郅	uiff
紙	uifm
職	uifn
織	uifo
縶	uifp
酈	uifq
阤	uifr
阯	uifs
聀	uift
紩	uifu
綕	uifv
絺	uifw
聜	uifx
旘	uify
隲	uifz
庤	uigm
庢	uign
戠	uigo
瓡	uigp
廌	uigq
稚	uih
秩	uihb
炙	uihc
亊	uihm
秇	uihn
秓	uiho
秖	uihp
秪	uihq
秲	uihr
秷	uihs
稙	uiht
稺	uihu
熫	uihv
穉	uihw
枝	uii
植	uiib
桎	uiic
栉	uiid
栀	uiie
枳	uiif
梔	uiim
櫛	uiin
杝	uiio
杫	uiip
柣	uiiq
栺	uiir
梽	uiis
楖	uiit
椥	uiiu
榰	uiiv
槯	uiiw
樀	uiix
樲	uiiy
樴	uiiz
帜	uij
觯	uijb
卮	uijc
帙	uijd
幟	uijm
觶	uijn
凪	uijo
帋	uijp
斦	uijq
釞	uijr
铚	uijs
觗	uijt
觝	uiju
锧	uijv
鉄	uijw
覟	uijx
銍	uijy
銴	uijz
衼	uikm
衹	uikn
袟	uiko
袠	uikp
筫	uikq
製	uikr
襧	uiks
肢	uil
脂	uilb
膣	uilc
胝	uild
劧	uilm
胑	uiln
胵	uilo
膱	uilp
骘	uim
騭	uimm
眰	uimn
馶	uimo
馽	uimp
駤	uimq
驇	uimr
騺	uims
鼅	uimt
鸷	uin
鷙	uinm
妷	uinn
姪	uino
娡	uinp
犆	uinq
媞	uinr
鳷	uins
嬂	uint
鴙	uinu
鴲	uinv
鶨	uinw
只	uio
吱	uiob
呮	uiom
嚔	uion
咫	uip
砋	uipm
礩	uipn
酯	uiq
狾	uiqm
猘	uiqn
智	uir
旨	uirb
晊	uirm
知	uis
直	uisb
置	uisc
峙	uisd
氏	uise
祗	uisf
祉	uisg
彘	uish
巵	uism
祇	uisn
祑	uiso
祬	uisp
崻	uisq
禃	uisr
禔	uiss
軄	uist
址	uit
埴	uitb
執	uitm
坁	uitn
坧	uito
垁	uitp
畤	uitq
墆	uitr
墌	uits
芝	uiu
芷	uiub
芖	uium
茋	uiun
茝	uiuo
菭	uiup
薙	uiuq
藢	uiur
蘵	uius
值	uiv
侄	uivb
伿	uivm
俧	uivn
値	uivo
倁	uivp
偫	uivq
乿	uivr
傂	uivs
儨	uivt
致	uiw
璏	uiwm
瓆	uiwn
志	uix
窒	uixb
忮	uixc
夛	uixm
恉	uixn
慹	uixo
憄	uixp
懥	uixq
懫	uixr
识	uiy
黹	uiyb
誌	uiym
識	uiyn
訨	uiyo
翐	uiyp
謢	uiyq
鯯	uiyr
支	uiz
至	uizb
止	uizc
趾	uizd
雉	uize
跖	uizf
豸	uizg
踯	uizh
踬	uizi
隻	uizm
躑	uizn
躓	uizo
迣	uizp
歭	uizq
雙	uizr
臷	uizs
臸	uizt
跱	uizu
疐	uizv
蹛	uizw
蹠	uizx
蹢	uizy
准	ukb
宒	ukbm
凖	ukbn
衠	ukcm
準	ukem
綧	ukfm
屯	ukh
稕	ukhm
肫	ukl
啍	ukom
旽	ukrm
圫	uktm
甽	uktn
埻	ukto
窀	ukx
忳	ukxm
谆	uky
諄	ukym
訰	ukyn
迍	ukzm
搌	ula
占	ulb
辗	ulc
輾	ulcm
蛅	ulcn
輚	ulco
轏	ulcp
沾	ule
湛	uleb
绽	ulf
旃	ulfb
綻	ulfm
飐	ulfn
颭	ulfo
旜	ulfp
战	ulg
戰	ulgm
戦	ulgn
魙	ulgo
虦	ulhm
虥	ulhn
黵	ulho
栈	uli
棧	ulim
枬	ulin
桟	ulio
栴	ulip
榐	uliq
橏	ulir
欃	ulis
斩	ulj
斬	uljm
覱	uljn
襢	ulkm
站	ull
粘	ulm
盏	ulmb
瞻	ulmc
毡	ulmd
盞	ulmm
氈	ulmn
驏	ulmo
閚	ulmp
氊	ulmq
驙	ulmr
鳽	ulnm
嫸	ulnn
鹯	ulno
鸇	ulnp
噡	ulom
展	ulp
碊	ulpm
皽	ulpn
醆	ulqm
霑	ulrm
崭	uls
嶄	ulsm
飦	ulsn
嵁	ulso
嶃	ulsp
嶘	ulsq
嶦	ulsr
餰	ulss
饘	ulst
蘸	ulu
菚	ulum
薝	ulun
佔	ulvm
偡	ulvn
僝	ulvo
琖	ulwm
怗	ulxm
惉	ulxn
詹	uly
颤	ulyb
谵	ulyc
顫	ulym
譫	ulyn
詀	ulyo
譧	ulyp
鳣	ulyq
鱣	ulyr
讝	ulys
趈	ulzm
跕	ulzn
邅	ulzo
捉	uoa
拙	uoab
擢	uoac
捔	uoam
擆	uoan
撯	uoao
彴	uocm
蝃	uocn
蠗	uoco
蠿	uocp
剢	uodm
劅	uodn
浊	uoe
涿	uoeb
濯	uoec
浞	uoed
濁	uoem
汋	uoen
灂	uoeo
缴	uof
繳	uofm
聉	uofn
灼	uoh
焯	uohb
炪	uohm
烵	uohn
燋	uoho
穛	uohp
穱	uohq
桌	uoi
梲	uoim
棁	uoin
椓	uoio
棳	uoip
槕	uoiq
櫡	uoir
镯	uoj
鐲	uojm
斱	uojn
斮	uojo
斲	uojp
鋜	uojq
斵	uojr
鐯	uojs
篧	uokm
籗	uokn
籱	uoko
着	uom
矠	uomm
妰	uonm
娺	uonn
鵫	uono
鷟	uonp
啄	uoo
啅	uoom
噣	uoon
斫	uop
硺	uopm
酌	uoq
犳	uoqm
晫	uorm
卓	uos
禚	uosb
罬	uosm
圴	uotm
墌	uotn
茁	uou
著	uoub
蓔	uoum
藋	uoun
倬	uov
琢	uow
琸	uowm
斀	uown
窧	uoxm
窡	uoxn
诼	uoy
諑	uoym
叕	uoyn
丵	uoyo
諁	uoyp
謶	uoyq
趠	uozm
蹠	uozn
这	upz
這	upzm
撞	uqa
奘	uqd
湷	uqem
漴	uqen
庄	uqg
庒	uqgm
焋	uqhm
桩	uqi
樁	uqim
梉	uqin
幢	uqj
装	uqk
裝	uqkm
粧	uqmm
糚	uqmn
妆	uqn
妝	uqnm
娤	uqnn
壮	uqp
状	uqq
狀	uqqm
獞	uqqn
壯	uqsm
壵	uqsn
莊	uqum
荘	uqun
僮	uqv
戆	uqx
戇	uqxm
戅	uqxn
撰	ura
摶	uram
赚	urb
賺	urbm
转	urc
專	urcm
轉	urcn
専	urco
転	urcp
蟤	urcq
剸	urdm
耑	urem
漙	uren
鄟	urfm
縳	urfn
专	urh
灷	urhm
篆	urk
篹	urkm
篿	urkn
襈	urko
簨	urkp
籑	urkq
腞	urlm
膞	urln
竱	urlo
嫥	urnm
啭	uro
囀	urom
砖	urp
磚	urpm
磗	urpn
馔	urs
饌	ursm
叀	ursn
堟	urtm
塼	urtn
蒃	urum
传	urv
傳	urvm
僝	urvn
僎	urvo
瑑	urwm
瑼	urwn
甎	urwo
恮	urxm
颛	ury
顓	urym
諯	uryn
譔	uryo
鱄	uryp
孨	urzm
瘇	usbm
螽	usc
彸	uscm
蚛	uscn
蜙	usco
蝩	uscp
徸	uscq
螤	uscr
刣	usdm
汷	usem
泈	usen
终	usf
終	usfm
緟	usfn
种	ush
種	ushm
炂	ushn
煄	usho
穜	ushp
柊	usim
钟	usj
锺	usjb
鐘	usjm
鍾	usjn
鈡	usjo
鈆	usjp
幒	usjq
銿	usjr
衷	usk
衶	uskm
衳	uskn
筗	usko
籦	uskp
中	usl
肿	uslb
腫	uslm
冢	usm
盅	usmb
眾	usmm
妕	usnm
妐	usnn
媑	usno
鴤	usnp
喠	usom
重	usp
狆	usqm
祌	ussm
鼨	ussn
堹	ustm
塚	ustn
茽	usum
蔠	usun
众	usv
仲	usvb
伀	usvm
偅	usvn
斔	uswm
忠	usx
忪	usxb
衆	usxm
尰	usym
諥	usyn
踵	usz
舯	uszb
夂	uszc
迚	uszm
歱	uszn
蹱	uszo
拄	uua
拀	uuam
贮	uub
瘃	uubb
疰	uubc
貯	uubm
寧	uubn
宔	uubo
癷	uubp
蛛	uuc
蛀	uucb
術	uucm
虲	uucn
尌	uuco
軴	uucp
徚	uucq
蝫	uucr
蝊	uucs
蠋	uuct
蠩	uucu
蠾	uucv
主	uud
丶	uudb
劚	uudm
注	uue
渚	uueb
洙	uuec
潴	uued
瀦	uuem
泏	uuen
濐	uueo
灟	uuep
邾	uuf
纻	uufm
聁	uufn
陼	uufo
紸	uufp
紵	uufq
絑	uufr
庻	uugm
煮	uuh
烛	uuhb
炷	uuhc
燭	uuhm
炢	uuhn
烪	uuho
秼	uuhp
焑	uuhq
煑	uuhr
稥	uuhs
燞	uuht
燝	uuhu
爥	uuhv
朱	uui
柱	uuib
株	uuic
术	uuid
杼	uuie
槠	uuif
橥	uuig
櫧	uuim
櫫	uuin
朮	uuio
柷	uuip
樦	uuiq
櫡	uuir
欘	uuis
铸	uuj
铢	uujb
鑄	uujm
銖	uujn
帾	uujo
鉒	uujp
鋳	uujq
鍂	uujr
鐢	uujs
斸	uujt
钃	uuju
竹	uuk
筑	uukb
褚	uukc
竺	uukd
箸	uuke
築	uukm
笁	uukn
笜	uuko
袾	uukp
袰	uukq
筯	uukr
篫	uuks
篴	uukt
簗	uuku
助	uul
麈	uulb
劯	uulm
朑	uuln
竚	uulo
麆	uulp
驻	uum
瞩	uumb
駐	uumm
矚	uumn
毜	uumo
毝	uump
眝	uumq
毮	uumr
馵	uums
駯	uumt
鼄	uumu
闧	uumv
鴸	uunm
鸀	uunn
孎	uuno
嘱	uuo
囑	uuom
嗻	uuon
属	uup
屬	uupm
殶	uupn
砫	uupo
屗	uupp
硃	uupq
磩	uupr
猪	uuq
曢	uurm
霻	uurn
曯	uuro
祝	uus
豬	uusm
壴	uusn
罜	uuso
祩	uusp
嵀	uusq
飳	uusr
坾	uutm
墸	uutn
著	uuu
茱	uuub
苎	uuuc
苧	uuum
芧	uuun
茿	uuuo
莇	uuup
蒊	uuuq
蓫	uuur
蕏	uuus
薴	uuut
藸	uuuu
藷	uuuv
住	uuv
侏	uuvb
伫	uuvc
佇	uuvm
乼	uuvn
珠	uuw
敱	uuwm
敳	uuwn
斀	uuwo
窋	uuxm
诸	uuy
诛	uuyb
翥	uuyc
註	uuym
誅	uuyn
諸	uuyo
羜	uuyp
詝	uuyq
鮢	uuyr
鯺	uuys
鱁	uuyt
逐	uuz
躅	uuzb
舳	uuzc
迬	uuzm
逫	uuzn
跙	uuzo
跓	uuzp
跦	uuzq
艈	uuzr
赘	uvb
贅	uvbm
轛	uvcm
奞	uvdm
沝	uvem
缀	uvf
缒	uvfb
隊	uvfm
綴	uvfn
縋	uvfo
椎	uvi
锥	uvj
錐	uvjm
錣	uvjn
鑆	uvjo
笍	uvkm
箠	uvkn
腏	uvlm
膇	uvln
骓	uvm
騅	uvmm
娷	uvnm
鵻	uvnn
硾	uvpm
礈	uvpn
醀	uvqm
醊	uvqn
餟	uvsm
坠	uvt
墜	uvtm
埀	uvtn
畷	uvto
萑	uvu
倕	uvvm
甀	uvwm
惴	uvx
諈	uvym
追	uvz
隹	uvzb
抓	uwa
挝	uwab
撾	uwam
髽	uwbm
蛀	uwc
檛	uwim
簻	uwkm
膼	uwlm
瞩	uwm
爪	uwz
爫	uwzm
拽	uya
捙	uyam
轉	uycm
睉	uymm
跩	uyzm
挣	uza
拯	uzab
掙	uzam
抍	uzan
掟	uzao
揁	uzap
撜	uzaq
症	uzb
癥	uzbm
鬇	uzbn
征	uzc
徵	uzcb
徎	uzcm
徰	uzcn
徴	uzco
争	uzd
湞	uzem
氶	uzen
浧	uzeo
郑	uzf
鄭	uzfm
糽	uzfn
聇	uzfo
綪	uzfp
緻	uzfy
豒	uzfz
丁	uzh
炡	uzhm
烝	uzhn
櫍	uziz
铮	uzj
钲	uzjb
幀	uzjm
鉦	uzjn
錚	uzjo
凧	uzjp
幁	uzjq
鏳	uzjr
鋕	uzjy
鑕	uzjz
筝	uzk
箏	uzkm
篜	uzkn
脀	uzlm
睁	uzm
睜	uzmm
眐	uzmn
姃	uznm
媜	uznn
鴊	uzno
狰	uzq
猙	uzqm
靕	uzqn
晸	uzrm
峥	uzs
崢	uzsm
崝	uzsn
埩	uztm
埥	uztn
塣	uzto
蒸	uzu
倀	uzvm
佂	uzvn
政	uzw
整	uzwb
怔	uzx
愸	uzxm
憕	uzxn
证	uzy
诤	uzyb
證	uzym
諍	uzyn
鯖	uzyo
証	uzyp
鮏	uzyq
正	uzz
爭	uzzm
踭	uzzn
插	vaa
搽	vaab
扱	vaam
扠	vaan
挿	vaao
捈	vaap
揷	vaaq
摖	vaar
察	vab
刹	vad
剎	vadm
汊	vae
紁	vafm
差	vag
靫	vagm
秅	vahm
查	vai
杈	vaib
檫	vaic
槎	vaid
楂	vaie
査	vaim
梌	vain
锸	vaj
镲	vajb
鍤	vajm
鑔	vajn
臿	vajo
銟	vajp
鎈	vajq
衩	vak
姹	van
奼	vanm
嚓	vao
喳	vaob
嗏	vaom
碴	vap
猹	vaq
岔	vas
馇	vasb
餷	vasm
嵖	vasn
垞	vatm
疀	vatn
茶	vau
茬	vaub
芆	vaum
仛	vavm
侘	vavn
偛	vavo
叉	vay
诧	vayb
詫	vaym
詧	vayn
艖	vazm
蹅	vazn
抄	vca
摷	vcam
巢	vcc
巣	vccm
轈	vccn
剿	vcd
劋	vcdm
潮	vce
漅	vcem
绰	vcf
綽	vcfm
鄛	vcfn
弨	vcgm
炒	vch
焯	vchb
焣	vchm
煼	vchn
槱	vcim
樔	vcin
钞	vcj
鈔	vcjm
觘	vcjn
朝	vcl
耖	vclb
勦	vclm
眧	vcmm
粆	vcmn
鼌	vcmo
麨	vcmp
鼂	vcmq
吵	vco
嘲	vcob
牊	vcpm
欩	vcqm
晁	vcr
禉	vcsm
罺	vcsn
巐	vcso
仦	vcvm
仯	vcvn
怊	vcx
窲	vcxm
窼	vcxn
訬	vcym
謿	vcyn
超	vcz
拆	vda
瘥	vdb
虿	vdc
蠆	vdcm
差	vdg
柴	vdi
钗	vdj
釵	vdjm
袃	vdkm
肞	vdlm
喍	vdom
囆	vdon
犲	vdqm
祡	vdsm
芆	vdum
茝	vdun
侪	vdv
儕	vdvm
訍	vdym
豺	vdz
撤	vea
扯	veab
掣	veac
揊	veam
撦	vean
摰	veao
车	vec
彻	vecb
車	vecm
徹	vecn
蛼	veco
奲	vedm
澈	vee
聅	vefm
烢	vehm
烲	vehn
焎	veho
爡	vehp
屮	vel
勶	velm
瞮	vemm
呫	veom
唓	veon
尺	vep
砗	vepb
硨	vepm
硩	vepn
坼	vet
莗	veum
伡	vevm
俥	vevn
偖	vevo
頙	veym
迠	vezm
抽	vfa
掫	vfam
搊	vfan
瘳	vfb
皗	vfbm
殠	vfdm
绸	vff
綢	vffm
紬	vffn
絒	vffo
魗	vfgm
稠	vfh
丒	vfhm
燽	vfhn
杽	vfim
杻	vfin
栦	vfio
梼	vfip
椆	vfiq
檮	vfir
帱	vfj
幬	vfjm
筹	vfk
籌	vfkm
裯	vfkn
篘	vfko
瞅	vfm
盩	vfmm
矁	vfmn
牰	vfnm
婤	vfnn
嬦	vfno
犨	vfnp
犫	vfnq
吜	vfom
嚋	vfon
酬	vfq
醜	vfqm
酧	vfqn
醔	vfqo
醻	vfqp
畴	vft
疇	vftm
畤	vftn
菗	vfum
薵	vfun
仇	vfv
丑	vfvb
俦	vfvc
儔	vfvm
偢	vfvn
愁	vfx
惆	vfxb
怞	vfxm
懤	vfxn
讎	vfym
诪	vfyn
詶	vfyo
鮘	vfyp
譸	vfyq
讐	vfyr
臭	vfz
踌	vfzb
雠	vfzc
躊	vfzm
遚	vfzn
臰	vfzo
跾	vfzp
雔	vfzq
雦	vfzr
抻	vga
捵	vgam
揨	vgan
宸	vgb
疢	vgbm
瘎	vgbn
賝	vgbo
瘨	vgbp
贂	vgbq
臣	vgc
辰	vgcb
龀	vgcc
齔	vgcm
軙	vgcn
齓	vgco
螴	vgcp
沉	vge
沈	vgeb
陈	vgf
郴	vgfb
陳	vgfm
綝	vgfn
称	vgh
稱	vghm
烥	vghn
煁	vgho
穪	vghp
榇	vgi
櫬	vgim
栕	vgin
桭	vgio
梣	vgip
棽	vgiq
樄	vgir
鈂	vgjm
鍖	vgjn
衬	vgk
襯	vgkm
肜	vgl
麎	vglm
瞋	vgmm
鷐	vgnm
嗔	vgo
嚫	vgom
碜	vgp
磣	vgpm
硶	vgpn
醦	vgqm
晨	vgr
霃	vgrm
曟	vgrn
塵	vgtm
墋	vgtn
茞	vgum
莀	vgun
莐	vguo
蔯	vgup
薼	vguq
伧	vgv
傖	vgvm
偁	vgvn
儭	vgvo
琛	vgw
敐	vgwm
敶	vgwn
尘	vgx
忱	vgxb
愖	vgxm
夦	vgxn
谌	vgy
谶	vgyb
諶	vgym
讖	vgyn
訦	vgyo
諃	vgyp
謓	vgyq
趁	vgz
迧	vgzm
爯	vgzn
趻	vgzo
趂	vgzp
跈	vgzq
踸	vgzr
鬯	vhb
长	vhc
厂	vhcb
徜	vhcc
長	vhcm
镸	vhcn
兏	vhco
厰	vhcp
蟐	vhcq
淐	vhem
廠	vhgm
甞	vhgn
鼚	vhgo
焻	vhhm
椙	vhim
常	vhj
锠	vhjm
鋹	vhjn
鋿	vhjo
錩	vhjp
裳	vhk
裮	vhkm
肠	vhl
畅	vhlb
腸	vhlm
膓	vhln
氅	vhm
阊	vhmb
閶	vhmm
闛	vhmn
嫦	vhn
娼	vhnb
唱	vho
嘗	vhom
嚐	vhon
猖	vhq
昌	vhr
昶	vhrb
暢	vhrm
场	vht
場	vhtm
塲	vhtn
畼	vhto
苌	vhu
菖	vhub
萇	vhum
偿	vhv
倡	vhvb
倘	vhvc
伥	vhvd
償	vhvm
倀	vhvn
仧	vhvo
仩	vhvp
僘	vhvq
敞	vhw
玚	vhwm
瓺	vhwn
琩	vhwo
瑒	vhwp
瑺	vhwq
韔	vhwr
尝	vhx
怅	vhxb
惝	vhxc
悵	vhxm
鲳	vhy
鯧	vhym
誯	vhyn
鲿	vhyo
鱨	vhyp
持	via
扡	viam
抶	vian
拸	viao
捇	viap
摛	viaq
攡	viar
痴	vib
匙	vibb
瘛	vibc
癡	vibm
貾	vibn
痸	vibo
瘈	vibp
赤	vic
齿	vicb
蚩	vicc
螭	vicd
彳	vice
齒	vicm
蚇	vicn
蚳	vico
徲	vicp
齝	vicq
豉	vid
奓	vidm
殦	vidn
池	vie
沶	viem
淔	vien
湁	vieo
漦	viep
耻	vif
絺	vifm
弛	vig
魑	vigb
炽	vih
熾	vihm
灻	vihn
烾	viho
黐	vihp
杘	viim
柅	viin
樆	viio
斥	vij
卶	vijm
鉓	vijn
銐	vijo
鉹	vijp
鍉	vijq
笞	vik
褫	vikb
篪	vikc
竾	vikm
袳	vikn
筂	viko
袲	vikp
裭	vikq
箎	vikr
箈	viks
肔	vilm
勅	viln
胣	vilo
勑	vilp
胵	vilq
耛	vilr
腟	vils
驰	vim
眵	vimb
馳	vimm
粚	vimn
瞝	vimo
麶	vimp
鸱	vin
媸	vinb
鴟	vinm
妛	vinn
鵄	vino
鶒	vinp
鶗	vinq
鶙	vinr
鷘	vins
吃	vio
嗤	viob
哧	vioc
叱	viod
啻	vioe
叺	viom
呎	vion
喫	vioo
噄	viop
噭	vioq
尺	vip
硳	vipm
狋	viqm
欼	viqn
雴	virm
饬	vis
飭	vism
岻	visn
彨	viso
饎	visp
彲	visq
墀	vit
坻	vitb
垑	vitm
茌	viu
荎	vium
菭	viun
侈	viv
傺	vivb
伬	vivm
佁	vivn
侙	vivo
俿	vivp
敕	viw
瓻	viwm
恥	vixm
恜	vixn
憏	vixo
慗	vixp
慸	vixq
懘	vixr
翅	viy
翄	viym
訵	viyn
誃	viyo
翤	viyp
誺	viyq
翨	viyr
謘	viys
迟	viz
踟	vizb
遲	vizm
迡	vizn
歭	vizo
赿	vizp
歯	vizq
遅	vizr
跢	vizs
遟	vizt
遫	vizu
趩	vizv
邌	vizw
賰	vkbm
蠢	vkc
蝽	vkcb
輴	vkcm
淳	vke
浱	vkem
湻	vken
滣	vkeo
漘	vkep
纯	vkf
純	vkfm
陙	vkfn
椿	vki
杶	vkim
槆	vkin
橁	vkio
櫄	vkip
錞	vkjm
箺	vkkm
脣	vklm
膞	vkln
睶	vkmm
鹑	vkn
鶉	vknm
犉	vknn
媋	vkno
鶞	vknp
唇	vko
醇	vkq
醕	vkqm
春	vkr
旾	vkrm
暙	vkrn
堾	vktm
莼	vku
蒓	vkum
芚	vkun
萅	vkuo
萶	vkup
蓴	vkuq
偆	vkvm
瑃	vkwm
惷	vkxm
鯙	vkym
鰆	vkyn
搀	vla
掺	vlab
摻	vlam
攙	vlan
摲	vlao
摌	vlap
单	vlb
冁	vlbb
毚	vlbm
蝉	vlc
蟾	vlcb
蟬	vlcm
螹	vlcn
刬	vldm
剗	vldn
剷	vldo
劖	vldp
潺	vle
澶	vleb
浐	vlem
湹	vlen
滻	vleo
潹	vlep
瀍	vleq
瀺	vler
灛	vles
缠	vlf
纏	vlfm
斺	vlfn
緂	vlfo
緾	vlfp
鄽	vlfq
繟	vlfr
酁	vlfs
繵	vlft
纒	vlfu
廛	vlg
韂	vlgm
煘	vlhm
燀	vlhn
梴	vlim
棎	vlin
欃	vlio
铲	vlj
觇	vljb
鏟	vljm
覘	vljn
鋋	vljo
幝	vljp
鋓	vljq
幨	vljr
镵	vljs
鑱	vljt
裧	vlkm
簅	vlkn
襜	vlko
丳	vllm
阐	vlm
骣	vlmb
闡	vlmm
驏	vlmn
閳	vlmo
婵	vln
嬋	vlnm
單	vlom
囅	vlon
啴	vloo
嘽	vlop
嚵	vloq
孱	vlp
羼	vlpb
硟	vlpm
磛	vlpn
獑	vlqm
醦	vlqn
旵	vlrm
馋	vls
禅	vlsb
產	vlsm
嶄	vlsn
饞	vlso
禪	vlsp
産	vlsq
嶃	vlsr
嵼	vlss
巉	vlst
产	vlt
壥	vltm
蒇	vlu
蕆	vlum
苂	vlun
僝	vlvm
儃	vlvn
儳	vlvo
忏	vlx
懺	vlxm
懴	vlxn
颤	vly
谄	vlyb
谗	vlyc
顫	vlym
讒	vlyn
諂	vlyo
誗	vlyp
譂	vlyq
讇	vlyr
躔	vlz
辿	vlzm
艬	vlzn
拺	voam
擉	voan
辍	voc
龊	vocb
輟	vocm
齪	vocn
涰	voem
绰	vof
綽	vofm
繛	vofn
戳	vog
鏃	vojm
鋜	vojn
鑡	vojo
箹	vokm
娕	vonm
娖	vonn
婼	vono
婥	vonp
孎	vonq
啜	voo
吷	voom
哾	voon
嚽	vooo
磭	vopm
酫	voqm
歠	voqn
餟	vosm
惙	voxm
踔	voz
辶	vozb
辵	vozm
逴	vozn
踀	vozo
趠	vozp
摐	vqam
疮	vqb
瘡	vqbm
创	vqd
創	vqdm
刅	vqdn
刱	vqdo
剏	vqdp
剙	vqdq
床	vqg
橦	vqim
幢	vqj
朣	vqlm
闯	vqm
闖	vqmm
喠	vqom
噇	vqon
牀	vqpm
牎	vqpn
牕	vqpo
磢	vqpp
傸	vqvm
窗	vqx
怆	vqxb
愴	vqxm
窓	vqxn
窻	vqxo
賗	vrbm
川	vrc
巛	vrcb
輲	vrcm
剶	vrdm
汌	vrem
椽	vri
椯	vrim
钏	vrj
釧	vrjm
篅	vrkm
串	vrl
膞	vrlm
鶨	vrnm
喘	vro
氚	vrq
猭	vrqm
歂	vrqn
暷	vrrm
堾	vrtm
荈	vrum
传	vrv
傳	vrvm
僢	vrvn
玔	vrwm
圌	vrwn
瑏	vrwo
穿	vrx
舛	vrxb
船	vrz
遄	vrzb
舡	vrzc
舩	vrzm
踳	vrzn
揰	vsam
摏	vsan
冲	vsb
宠	vsbb
寵	vsbm
痋	vsbn
虫	vsc
蟲	vscm
蝩	vscn
衝	vsco
徸	vscp
沖	vsem
浺	vsen
漴	vseo
隀	vsfm
緟	vsfn
种	vsh
爞	vshm
铳	vsj
舂	vsjb
銃	vsjm
褈	vskm
嘃	vsom
重	vsp
崇	vss
崈	vssm
罿	vssn
充	vst
埫	vstm
茺	vsu
珫	vswm
忡	vsx
憧	vsxb
憃	vsxm
翀	vsym
艟	vsz
蹖	vszm
搐	vua
摴	vuam
摢	vuan
厨	vuc
蜍	vucb
蟵	vucm
齣	vucn
齭	vuco
齼	vucp
初	vud
刍	vudb
滁	vue
泏	vuem
滀	vuen
濋	vueo
除	vuf
绌	vufb
絀	vufm
鄐	vufn
廚	vugm
黜	vuh
亍	vuhb
處	vuhm
炪	vuhn
楚	vui
楮	vuib
杵	vuic
橱	vuid
樗	vuie
櫥	vuim
椘	vuin
榋	vuio
橻	vuip
檚	vuiq
櫉	vuir
櫖	vuis
触	vuj
锄	vujb
鋤	vujm
觸	vujn
処	vujo
鉏	vujp
斶	vujq
幮	vujr
出	vuk
褚	vukb
篨	vukm
竌	vulm
竐	vuln
耝	vulo
耡	vulp
臅	vulq
閦	vumm
媰	vunm
犓	vunn
鶵	vuno
嘼	vuom
础	vup
礎	vupm
欪	vuqm
歜	vuqn
矗	vus
岀	vusm
豖	vusn
豠	vuso
禇	vusp
畜	vut
埱	vutm
芻	vuum
菆	vuun
蒢	vuuo
蒭	vuup
藸	vuuq
储	vuv
儲	vuvm
俶	vuvn
傗	vuvo
儊	vuvp
敊	vuwm
珿	vuwn
琡	vuwo
璴	vuwp
怵	vux
憷	vuxb
懨	vuxm
慉	vuxn
諔	vuym
处	vuz
雏	vuzb
躇	vuzc
蹰	vuzd
雛	vuzm
躕	vuzn
趎	vuzo
貙	vuzp
捶	vva
搥	vvam
陲	vvf
缍	vvfb
炊	vvh
椎	vvi
槌	vvib
棰	vvic
桘	vvim
锤	vvj
錘	vvjm
鎚	vvjn
箠	vvkm
腄	vvlm
吹	vvo
垂	vvp
硾	vvpm
埀	vvtm
菙	vvum
倕	vvvm
圌	vvwm
惙	vvxm
顀	vvym
龡	vvyn
欻	vwqm
揣	vya
搋	vyab
膪	vyl
膗	vylm
啜	vyo
嘬	vyob
欼	vyqm
踹	vyz
承	vza
撑	vzab
搶	vzam
撐	vzan
挰	vzao
掁	vzap
揨	vzaq
摚	vzar
撜	vzas
凈	vzbm
宬	vzbn
蛏	vzc
蟶	vzcm
徎	vzcn
赪	vzco
赬	vzcp
澄	vze
氶	vzem
泟	vzen
洆	vzeo
浾	vzep
浧	vzeq
淨	vzer
溗	vzes
澂	vzet
瀓	vzeu
阷	vzfm
郕	vzfn
絾	vzfo
緽	vzfp
罉	vzfq
成	vzg
庱	vzgm
程	vzh
称	vzhb
丞	vzhc
秤	vzhd
稱	vzhm
穪	vzhn
橙	vzi
柽	vzib
枨	vzic
棖	vzim
檉	vzin
朾	vzio
棦	vzip
椉	vziq
橖	vzir
橕	vzis
檙	vzit
铖	vzj
铛	vzjb
鋮	vzjm
鐺	vzjn
鎗	vzjo
鏿	vzjp
鐣	vzjq
裎	vzk
筬	vzkm
塍	vzl
脭	vzlm
骋	vzm
盛	vzmb
瞠	vzmc
騁	vzmm
睈	vzmn
矃	vzmo
騬	vzmp
娍	vznm
呈	vzo
乘	vzp
乗	vzpm
碀	vzpn
酲	vzq
靗	vzqm
晿	vzrm
峸	vzsm
饓	vzsn
城	vzt
埕	vztb
埩	vztm
堘	vztn
塖	vzto
畻	vztp
荿	vzum
侱	vzvm
偁	vzvn
僜	vzvo
珹	vzwm
琤	vzwn
珵	vzwo
惩	vzx
懲	vzxm
悜	vzxn
窚	vzxo
憆	vzxp
憕	vzxq
竀	vzxr
诚	vzy
誠	vzym
牚	vzyn
頳	vzyo
鯎	vzyp
逞	vzz
爯	vzzm
挖	waa
搲	waam
攨	waan
蛙	wac
徍	wacm
洼	wae
溛	waem
漥	waen
邷	wafm
聉	wafn
韈	wagm
帓	wajm
袜	wak
襪	wakm
腽	wal
膃	walm
劸	waln
鼃	wamm
娃	wan
娲	wanb
媧	wanm
婠	wann
哇	wao
咼	waom
咓	waon
唲	waoo
啘	waop
嗢	waoq
嗗	waor
砙	wapm
屲	wasm
畖	watm
佤	wav
瓦	waw
瓲	wawm
瓾	wawn
韎	wawo
韤	wawp
窪	waxm
穵	waxn
窊	waxo
窐	waxp
鮭	waym
瀤	wdem
竵	wdlm
咼	wdom
喎	wdon
崴	wds
外	wdx
夞	wdxm
顡	wdym
歪	wdz
抆	wgam
揾	wgan
搵	wgao
瘟	wgb
瘒	wgbm
蚊	wgc
蚉	wgcm
辒	wgcn
輼	wgco
螡	wgcp
轀	wgcq
蟁	wgcr
刎	wgd
歾	wgdm
殟	wgdn
温	wge
汶	wgeb
溫	wgem
渂	wgen
纹	wgf
紊	wgfb
紋	wgfm
聞	wgfn
缊	wgfo
絻	wgfp
緼	wgfq
縕	wgfr
繧	wgfs
鞰	wggm
稳	wgh
穩	wghm
炆	wghn
穏	wgho
桽	wgim
榅	wgin
榲	wgio
鎾	wgjm
肳	wglm
脕	wgln
脗	wglo
问	wgm
闻	wgmb
阌	wgmc
閿	wgmm
駇	wgmn
馼	wgmo
閺	wgmp
闅	wgmq
闦	wgmr
妏	wgnm
鳼	wgnn
鴍	wgno
吻	wgo
問	wgom
呅	wgon
呡	wgoo
雯	wgr
昷	wgrm
彣	wgsm
豱	wgsn
鼤	wgso
饂	wgsp
亠	wgt
塭	wgtm
蕴	wgu
芠	wgum
莬	wgun
蕰	wguo
伆	wgvm
文	wgw
玟	wgwb
璺	wgwc
攵	wgwd
韞	wgwm
珳	wgwn
瑥	wgwo
忟	wgxm
忞	wgxn
魰	wgym
鳁	wgyn
顐	wgyo
鰛	wgyp
鰮	wgyq
夂	wgz
抂	wham
尣	whbm
尩	whbn
往	whc
辋	whcb
輞	whcm
彺	whcn
徃	whco
徍	whcp
蚟	whcq
蛧	whcr
蝄	whcs
汪	whe
瀇	whem
網	whfm
魍	whg
枉	whi
棢	whim
望	whl
朚	whlm
朢	whln
盳	whmm
妄	whn
旺	whr
兦	whrm
暀	whrn
罒	whsm
亡	wht
网	whtb
罔	whtc
罓	whtm
莣	whum
菵	whun
亾	whvm
仼	whvn
王	whw
尫	whwm
忘	whx
惘	whxb
忹	whxm
尪	whym
誷	whyn
迋	whzm
迬	whzn
挽	wla
抏	wlam
捖	wlan
捥	wlao
掔	wlap
完	wlb
宛	wlbb
皖	wlbc
貦	wlbm
贃	wlbn
贎	wlbo
蜿	wlc
蚖	wlcm
輓	wlcn
輐	wlco
蟃	wlcp
豌	wld
剜	wldb
刓	wldm
湾	wle
灣	wlem
汍	wlen
涴	wleo
澫	wlep
潫	wleq
纨	wlf
绾	wlfb
紈	wlfm
綰	wlfn
鄤	wlfo
絻	wlfp
綄	wlfq
綩	wlfr
弯	wlg
彎	wlgm
万	wlh
烷	wlhb
杤	wlim
杬	wlin
梚	wlio
椀	wlip
槾	wliq
帵	wljm
鋄	wljn
鋔	wljo
錽	wljp
鋺	wljq
鍐	wljr
鎫	wljs
笂	wlkm
腕	wll
脘	wllb
脕	wllm
毌	wlmm
盌	wlmn
睕	wlmo
関	wlmp
瞣	wlmq
婉	wln
妧	wlnm
婠	wlnn
唍	wlom
碗	wlp
丸	wlpb
晚	wlr
晥	wlrm
晩	wlrn
晼	wlro
卐	wlsm
卍	wlsn
岏	wlso
畹	wlt
埦	wltm
塆	wltn
壪	wlto
蔓	wlu
莞	wlub
菀	wluc
芄	wlud
萬	wlum
莬	wlun
萖	wluo
薍	wlup
乛	wlvm
倇	wlvn
玩	wlw
琬	wlwb
琓	wlwm
惋	wlx
夘	wlxm
夗	wlxn
忨	wlxo
惌	wlxp
顽	wly
頑	wlym
翫	wlyn
踠	wlzm
握	woa
挝	woab
撾	woam
捰	woan
捼	woao
捾	woap
擭	woaq
卧	wob
蜗	woc
龌	wocb
臥	wocm
蝸	wocn
齷	woco
斡	wod
沃	woe
涡	woeb
渥	woec
渦	woem
涹	woen
涴	woeo
濄	woep
濣	woeq
緺	wofm
我	wog
焥	wohm
枂	woim
楃	woin
幄	woj
肟	wol
臒	wolm
腛	woln
龏	wolo
瞃	womm
媼	wonm
婐	wonn
婑	wono
媉	wonp
喔	woo
咼	woom
唩	woon
硪	wop
猧	woqm
堝	wotm
莴	wou
萵	woum
薶	woun
倭	wov
仴	wovm
偓	wovn
瓁	wowm
窝	wox
窩	woxm
馧	woxn
踒	wozm
踠	wozn
雘	wozo
捤	wpam
捼	wpan
揻	wpao
揋	wpap
撱	wpaq
撝	wpar
痿	wpb
痏	wpbm
寪	wpbn
癓	wpbo
癐	wpbp
微	wpc
尉	wpcb
軎	wpcc
衛	wpcm
厃	wpcn
徫	wpco
蜲	wpcp
蜼	wpcq
蝛	wpcr
蝟	wpcs
衞	wpct
螱	wpcu
轊	wpcv
为	wpd
危	wpdb
渭	wpe
潍	wpeb
洧	wpec
沩	wped
涠	wpee
濰	wpem
溈	wpen
潿	wpeo
洈	wpep
浘	wpeq
渨	wper
湋	wpes
溦	wpet
潙	wpeu
濊	wpev
濻	wpew
瀢	wpex
维	wpf
纬	wpfb
隗	wpfc
隈	wpfd
維	wpfm
緯	wpfn
隇	wpfo
鄬	wpfp
縅	wpfq
緭	wpfr
颹	wpfs
威	wpg
魏	wpgb
骩	wpgm
骪	wpgn
骫	wpgo
廆	wpgp
炜	wph
煨	wphb
為	wphm
煒	wphn
烓	wpho
煟	wphp
熭	wphq
燰	wphr
未	wpi
桅	wpib
梶	wpim
楲	wpin
椳	wpio
椲	wpip
欈	wpiq
卫	wpj
帷	wpjb
帏	wpjc
幃	wpjm
覣	wpjn
鍡	wpjo
鍏	wpjp
鏏	wpjq
覹	wpjr
褽	wpkm
胃	wpl
腲	wplm
闱	wpm
闈	wpmm
瞆	wpmn
瞶	wpmo
矀	wpmp
委	wpn
娓	wpnb
媙	wpnm
媦	wpnn
媁	wpno
犚	wpnp
犩	wpnq
味	wpo
唯	wpob
喂	wpoc
噲	wpom
唩	wpon
喴	wpoo
喡	wpop
尾	wpp
硙	wppm
硊	wppn
碨	wppo
磈	wppp
磑	wppq
猥	wpq
猬	wpqb
猚	wpqm
醀	wpqn
暐	wprm
霨	wprn
霺	wpro
巍	wps
崴	wpsb
嵬	wpsc
餵	wpsm
巋	wpsn
峗	wpso
峞	wpsp
崣	wpsq
嵔	wpsr
嶉	wpss
罻	wpst
嶶	wpsu
餧	wpsv
饖	wpsw
畏	wpt
圩	wptb
墛	wptm
壝	wptn
亹	wpto
薇	wpu
蔚	wpub
萎	wpuc
苇	wpud
葳	wpue
葦	wpum
芛	wpun
苿	wpuo
荱	wpup
菋	wpuq
葨	wpur
蒍	wpus
蓶	wput
蔿	wpuu
薳	wpuv
藯	wpuw
蘶	wpux
位	wpv
伟	wpvb
伪	wpvc
偎	wpvd
偽	wpvm
偉	wpvn
僞	wpvo
儰	wpvp
围	wpw
韦	wpwb
玮	wpwc
韪	wpwd
囗	wpwe
韋	wpwm
圍	wpwn
瑋	wpwo
韙	wpwp
囲	wpwq
琟	wpwr
韑	wpws
韡	wpwt
瓗	wpwu
斖	wpwv
慰	wpx
惟	wpxb
愄	wpxm
愇	wpxn
懀	wpxo
谓	wpy
诿	wpyb
鲔	wpyc
謂	wpym
諉	wpyn
鮪	wpyo
叞	wpyp
詴	wpyq
頠	wpyr
鮇	wpys
鳂	wpyt
鮠	wpyu
鳚	wpyv
鰄	wpyw
鰃	wpyx
讆	wpyy
讏	wpyz
违	wpz
遗	wpzb
逶	wpzc
艉	wpzd
違	wpzm
遺	wpzn
爲	wpzo
趡	wpzp
踓	wpzq
躗	wpzr
躛	wpzs
捂	wua
扜	wuam
扝	wuan
扤	wuao
摀	wuap
勿	wub
寤	wubb
痦	wubc
鼿	wubm
齀	wubn
蜈	wuc
螐	wucm
蟱	wucn
剭	wudm
奦	wudn
污	wue
浯	wueb
汙	wuem
汚	wuen
沕	wueo
洿	wuep
洖	wueq
渞	wuer
溩	wues
潕	wuet
邬	wuf
於	wufb
阢	wufc
鄔	wufm
郚	wufn
陚	wufo
隖	wufp
巫	wug
戊	wugb
庑	wugc
廡	wugm
弙	wugn
靰	wugo
五	wuh
无	wuhb
焐	wuhc
烏	wuhm
無	wuhn
熓	wuho
熃	wuhp
梧	wui
杌	wuib
杅	wuim
杇	wuin
柮	wuio
橆	wuip
钨	wuj
鋈	wujb
鎢	wujm
卼	wujn
釫	wujo
铻	wujp
幠	wujq
鋙	wujr
鋘	wujs
錻	wujt
箼	wukm
务	wul
務	wulm
膴	wuln
毋	wum
骛	wumb
騖	wumm
粅	wumn
瞴	wumo
物	wun
妩	wunb
鹉	wunc
鹜	wund
婺	wune
牾	wunf
嫵	wunm
鵡	wunn
鶩	wuno
娪	wunp
娒	wunq
娬	wunr
鹀	wuns
鴮	wunt
鵐	wunu
鷡	wunv
吴	wuo
呜	wuob
吾	wuoc
唔	wuod
吳	wuom
嗚	wuon
呉	wuoo
啎	wuop
屋	wup
午	wupb
乌	wupc
矹	wupm
碔	wupn
歍	wuqm
雾	wur
晤	wurb
霧	wurm
旿	wurn
雺	wuro
霚	wurp
霿	wurq
鼯	wus
屼	wusm
岉	wusn
峿	wuso
祦	wusp
嵍	wusq
嵨	wusr
禑	wuss
亡	wut
坞	wutb
圬	wutc
塢	wutm
堥	wutn
墲	wuto
芜	wuu
芴	wuub
蕪	wuum
莁	wuun
茣	wuuo
蘁	wuup
伍	wuv
侮	wuvb
仵	wuvc
乄	wuvm
亾	wuvn
俉	wuvo
倵	wuvp
僫	wuvq
儛	wuvr
兀	wuw
玝	wuwm
敄	wuwn
珸	wuwo
珷	wuwp
瑦	wuwq
璑	wuwr
甒	wuws
舞	wux
恶	wuxb
悟	wuxc
忤	wuxd
怃	wuxe
惡	wuxm
憮	wuxn
忢	wuxo
悮	wuxp
悞	wuxq
窏	wuxr
窹	wuxs
误	wuy
诬	wuyb
誣	wuym
誤	wuyn
誈	wuyo
鯃	wuyp
譕	wuyq
鰞	wuyr
武	wuz
迕	wuzb
逜	wuzm
趶	wuzn
躌	wuzo
攚	wzam
齆	wzbm
螉	wzcm
奣	wzdm
滃	wzem
聬	wzfm
罋	wzfn
鎓	wzjm
勜	wzlm
瞈	wzmm
鹟	wznm
鶲	wznn
嗡	wzo
暡	wzrm
嵡	wzsm
塕	wztm
蓊	wzu
蕹	wzub
瓮	wzw
甕	wzwm
翁	wzy
疦	xgbm
疶	xgbn
轌	xgcm
削	xgd
泶	xge
澩	xgem
泧	xgen
泬	xgeo
滈	xgep
瀥	xgeq
靴	xgg
鞾	xggm
燢	xghm
桖	xgim
梋	xgin
樰	xgio
觷	xgjm
袕	xgkm
膤	xglm
瞲	xgmm
鸴	xgnm
鷽	xgnn
噱	xgo
吷	xgom
狘	xgqm
雪	xgr
岤	xgsm
峃	xgsn
嶨	xgso
坹	xgtm
壆	xgtn
薛	xgu
茓	xgum
蒆	xgun
乴	xgvm
斈	xgwm
敩	xgwn
斆	xgwo
血	xgx
穴	xgxb
彐	xgxc
怴	xgxm
辥	xgxn
辪	xgxo
谑	xgy
鳕	xgyb
謔	xgym
鱈	xgyn
学	xgz
踅	xgzb
學	xgzm
趐	xgzn
艝	xgzo
扢	xiam
扱	xian
扸	xiao
摡	xiap
兮	xib
皙	xibb
卥	xibm
瘜	xibn
凞	xibo
蜥	xic
徙	xicb
蟋	xicc
螅	xicd
徆	xicm
赥	xicn
赩	xico
徯	xicp
蜤	xicq
蝷	xicr
螇	xics
蟢	xict
蠵	xicu
奚	xid
鬩	xidm
洗	xie
溪	xieb
汐	xiec
淅	xied
浠	xiee
渓	xiem
滊	xien
漇	xieo
漝	xiep
澙	xieq
潟	xier
潝	xies
系	xif
细	xifb
隙	xifc
郗	xifd
隰	xife
細	xifm
郤	xifn
匸	xifo
邜	xifp
郋	xifq
绤	xifr
鄎	xifs
隟	xift
綌	xifu
緆	xifv
縘	xifw
縰	xifx
繥	xify
繫	xifz
戏	xig
席	xigb
戲	xigm
廗	xign
戯	xigo
戱	xigp
豀	xigq
谿	xigr
稀	xih
熙	xihb
熄	xihc
熹	xihd
烯	xihe
焁	xihm
焈	xihn
焟	xiho
焬	xihp
煕	xihq
稧	xihr
熈	xihs
熂	xiht
黖	xihu
熺	xihv
熻	xihw
燨	xihx
虩	xihy
爔	xihz
析	xii
栖	xiib
檄	xiic
樨	xiid
棲	xiim
杫	xiin
枲	xiio
桸	xiip
椞	xiiq
椺	xiir
榽	xiis
槢	xiit
橲	xiiu
橀	xiiv
希	xij
锡	xijb
舄	xijc
铣	xijd
觋	xije
銑	xijm
錫	xijn
覡	xijo
钑	xijp
釳	xijq
釸	xijr
鈒	xijs
舃	xijt
鈢	xiju
厀	xijv
鉩	xijw
鉨	xijx
覤	xijy
鎴	xijz
袭	xik
裼	xikb
襲	xikm
膝	xil
腊	xilb
臘	xilm
肸	xiln
肹	xilo
釐	xilp
阋	xim
粞	ximb
盻	ximm
睎	ximn
瞦	ximo
糦	ximp
騱	ximq
闟	ximr
騽	xims
矖	ximt
驨	ximu
牺	xin
嬉	xinb
媳	xinc
犧	xinm
娭	xinn
犔	xino
嬆	xinp
犠	xinq
鵗	xinr
鸂	xins
喜	xio
吸	xiob
嘻	xioc
唏	xiod
呬	xiom
咥	xion
唽	xioo
喺	xiop
噏	xioq
嚱	xior
囍	xios
犀	xip
矽	xipb
硒	xipc
屣	xipd
屃	xipm
屓	xipn
屖	xipo
碏	xipp
磎	xipq
礂	xipr
磶	xips
屭	xipt
歙	xiq
醯	xiqb
欷	xiqc
欪	xiqm
欯	xiqn
氥	xiqo
狶	xiqp
獡	xiqq
歖	xiqr
晰	xir
昔	xirb
曦	xirc
雭	xirm
晞	xirn
晳	xiro
暿	xirp
霫	xirq
霼	xirr
禧	xis
饩	xisb
禊	xisc
鼷	xisd
餼	xism
卌	xisn
饻	xiso
嵠	xisp
豨	xisq
嶍	xisr
餏	xiss
嶲	xist
豯	xisu
巂	xisv
巇	xisw
鼰	xisx
饎	xisy
鼳	xisz
塈	xitm
塜	xitn
墍	xito
壐	xitp
茜	xiu
葸	xiub
蓰	xiuc
菥	xiud
莔	xium
莃	xiun
蔇	xiuo
葈	xiup
蒨	xiuq
蒠	xiur
蒵	xius
蓆	xiut
蕮	xiuu
薂	xiuv
习	xiv
僖	xivb
俙	xivm
係	xivn
傒	xivo
玺	xiw
璽	xiwm
琋	xiwn
瓕	xiwo
西	xix
息	xixb
惜	xixc
悉	xixd
夕	xixe
穸	xixf
愾	xixm
忚	xixn
忥	xixo
怬	xixp
怸	xixq
恄	xixr
恓	xixs
悕	xixt
惁	xixu
慀	xixv
憘	xixw
憙	xixx
窸	xixy
衋	xixz
羲	xiy
翕	xiyb
習	xiym
鰓	xiyn
誒	xiyo
羛	xiyp
翖	xiyq
諰	xiyr
謑	xiys
鯑	xiyt
謵	xiyu
鳛	xiyv
譆	xiyw
鰼	xiyx
鱚	xiyy
蹊	xiz
舾	xizb
趇	xizm
趘	xizn
貕	xizo
蹝	xizp
雟	xizq
躧	xizr
掀	xja
摻	xjam
搟	xjan
挦	xjao
搚	xjap
撊	xjaq
撏	xjar
攇	xjas
攕	xjat
贤	xjb
宪	xjbb
冼	xjbc
痫	xjbd
賢	xjbm
癇	xjbn
癎	xjbo
贒	xjbp
衔	xjc
蚬	xjcb
蜆	xjcm
臤	xjcn
軐	xjco
蚿	xjcp
蛝	xjcq
衘	xjcr
輱	xjcs
豏	xjdm
先	xje
洗	xjeb
涎	xjec
涀	xjem
湺	xjen
溓	xjeo
澖	xjep
瀗	xjeq
灦	xjer
线	xjf
险	xjfb
限	xjfc
陷	xjfd
纤	xjfe
險	xjfm
線	xjfn
縣	xjfo
纖	xjfp
陥	xjfq
険	xjfr
絃	xjfs
缐	xjft
絤	xjfu
綖	xjfv
綅	xjfw
綫	xjfx
繊	xjfy
纎	xjfz
弦	xjg
咸	xjgb
廯	xjgm
韅	xjgn
燹	xjh
秈	xjhm
烍	xjhn
稴	xjho
杴	xjim
枮	xjin
槏	xjio
橺	xjip
橌	xjiq
櫶	xjir
见	xjj
铣	xjjb
锨	xjjc
見	xjjm
銜	xjjn
銑	xjjo
鍁	xjjp
釤	xjjq
臽	xjjr
铦	xjjs
銛	xjjt
韯	xjju
鋧	xjjv
銽	xjjw
錎	xjjx
韱	xjjy
鍌	xjjz
筅	xjk
筧	xjkm
箲	xjkn
褼	xjko
襳	xjkp
腺	xjl
鹹	xjlm
胘	xjln
臔	xjlo
麙	xjlp
闲	xjm
籼	xjmb
閑	xjmm
闞	xjmn
盷	xjmo
県	xjmp
毨	xjmq
睍	xjmr
閒	xjms
粯	xjmt
瞯	xjmu
麲	xjmv
糮	xjmw
嫌	xjn
娴	xjnb
鹇	xjnc
嫻	xjnm
鷴	xjnn
奾	xjno
妶	xjnp
姺	xjnq
姭	xjnr
娊	xjns
婱	xjnt
娹	xjnu
嫺	xjnv
嬐	xjnw
孅	xjnx
鶱	xjny
鷼	xjnz
咞	xjom
咁	xjon
唌	xjoo
哯	xjop
啣	xjoq
嗛	xjor
嘕	xjos
硍	xjpm
礥	xjpn
献	xjq
酰	xjqb
氙	xjqc
猃	xjqd
獻	xjqm
獫	xjqn
欦	xjqo
狝	xjqp
醎	xjqq
獮	xjqr
醶	xjqs
玁	xjqt
显	xjr
霰	xjrb
晛	xjrm
县	xjs
馅	xjsb
祆	xjsc
岘	xjsd
彡	xjse
餡	xjsm
峴	xjsn
禰	xjso
屳	xjsp
崄	xjsq
禒	xjsr
嶮	xjss
鼸	xjst
堿	xjtm
垷	xjtn
埳	xjto
塪	xjtp
壏	xjtq
苋	xju
藓	xjub
莶	xjuc
莧	xjum
薟	xjun
蘞	xjuo
蘚	xjup
苮	xjuq
藖	xjur
仙	xjv
仚	xjvm
佡	xjvn
伭	xjvo
俔	xjvp
僊	xjvq
僲	xjvr
僴	xjvs
僩	xjvt
现	xjw
現	xjwm
玹	xjwn
珗	xjwo
甉	xjwp
憲	xjxm
慳	xjxn
忺	xjxo
尠	xjxp
尟	xjxq
憪	xjxr
憸	xjxs
懢	xjxt
馦	xjxu
鲜	xjy
羡	xjyb
羨	xjym
鮮	xjyn
顯	xjyo
誢	xjyp
誸	xjyq
羬	xjyr
諴	xjys
顈	xjyt
顕	xjyu
譀	xjyv
鰔	xjyw
譣	xjyx
鱻	xjyy
舷	xjz
暹	xjzb
跹	xjzc
跣	xjzd
躚	xjzm
赻	xjzn
蹮	xjzo
揗	xkam
撏	xkan
巽	xkb
寻	xkc
循	xkcb
徇	xkcc
尋	xkcm
蟫	xkcn
蟳	xkco
殉	xkd
奞	xkdm
洵	xke
浚	xkeb
汛	xkec
浔	xked
潯	xkem
潠	xken
濬	xkeo
灥	xkep
郇	xkf
紃	xkfm
鄩	xkfn
纁	xkfo
熏	xkh
焄	xkhm
稄	xkhn
煇	xkho
燅	xkhp
燂	xkhq
燖	xkhr
燻	xkhs
爓	xkht
爋	xkhu
杊	xkim
栒	xkin
桪	xkio
樳	xkip
鑂	xkjm
襑	xkkm
勋	xkl
勛	xklm
勲	xkln
勳	xklo
臐	xklp
驯	xkm
馴	xkmm
毥	xkmn
眴	xkmo
駨	xkmp
矄	xkmq
姰	xknm
鶽	xknn
咰	xkom
噚	xkon
噀	xkoo
嚑	xkop
殾	xkpm
醺	xkq
獯	xkqb
狥	xkqm
旬	xkr
曛	xkrb
峋	xks
卂	xksm
巺	xksn
埙	xkt
塤	xktm
坃	xktn
畃	xkto
壎	xktp
壦	xktq
荀	xku
薰	xkub
蕈	xkuc
荨	xkud
葷	xkum
蕁	xkun
蔒	xkuo
薫	xkup
蘍	xkuq
伨	xkvm
侚	xkvn
偱	xkvo
珣	xkwm
璕	xkwn
窨	xkx
恂	xkxb
愻	xkxm
训	xky
讯	xkyb
询	xkyc
鲟	xkyd
訓	xkym
訊	xkyn
詢	xkyo
鱘	xkyp
廵	xkyq
訙	xkyr
顨	xkys
鱏	xkyt
迅	xkz
巡	xkzb
逊	xkzc
孫	xkzm
遜	xkzn
迿	xkzo
攳	xkzp
揱	xmam
撨	xman
宵	xmb
宯	xmbm
痚	xmbn
痟	xmbo
皛	xmbp
皢	xmbq
蛸	xmc
蟏	xmcm
蟂	xmcn
轇	xmco
蟰	xmcp
蠨	xmcq
削	xmd
消	xme
潇	xmeb
淆	xmec
瀟	xmem
洨	xmen
涍	xmeo
漻	xmep
潚	xmeq
绡	xmf
綃	xmfm
郩	xmfn
颵	xmfo
縿	xmfp
魈	xmg
庨	xmgm
骹	xmgn
彇	xmgo
髇	xmgp
髐	xmgq
灲	xmhm
灱	xmhn
烋	xmho
虓	xmhp
焇	xmhq
熇	xmhr
燆	xmhs
穘	xmht
熽	xmhu
校	xmi
枭	xmib
枵	xmic
梟	xmim
橚	xmin
櫹	xmio
销	xmj
銷	xmjm
笑	xmk
箫	xmkb
筱	xmkc
簫	xmkm
笹	xmkn
筿	xmko
箾	xmkp
篠	xmkq
簘	xmkr
肖	xml
効	xmlm
膮	xmln
骁	xmm
驍	xmmm
睄	xmmn
鸮	xmnm
婋	xmnn
鴞	xmno
鴵	xmnp
鷍	xmnq
啸	xmo
嚣	xmob
哮	xmoc
哓	xmod
嘯	xmom
囂	xmon
嘵	xmoo
呺	xmop
咲	xmoq
啋	xmor
嗃	xmos
嘋	xmot
嘨	xmou
嘐	xmov
嚻	xmow
硝	xmp
硣	xmpm
殽	xmpn
毊	xmpo
猇	xmqm
歊	xmqn
獟	xmqo
獢	xmqp
歗	xmqq
晓	xmr
霄	xmrb
曉	xmrm
暁	xmrn
崤	xms
萧	xmu
蕭	xmum
莦	xmun
萷	xmuo
薂	xmup
藃	xmuq
虈	xmur
侾	xmvm
俲	xmvn
傚	xmvo
效	xmw
敩	xmwm
斅	xmwn
斆	xmwo
小	xmx
恔	xmxm
恷	xmxn
窙	xmxo
憢	xmxp
訤	xmym
翛	xmyn
詨	xmyo
誟	xmyp
誵	xmyq
謏	xmyr
謞	xmys
謼	xmyt
譊	xmyu
逍	xmz
孝	xmzb
踃	xmzm
宿	xnb
髹	xnbb
髤	xnbm
齅	xnbn
螑	xncm
溴	xne
滫	xnem
潃	xnen
绣	xnf
繡	xnfm
綉	xnfn
繍	xnfo
飍	xnfp
庥	xng
秀	xnh
烋	xnhm
烌	xnhn
朽	xni
樇	xnim
櫹	xnin
锈	xnj
銹	xnjm
銝	xnjn
鎀	xnjo
鏅	xnjp
鏥	xnjq
鏽	xnjr
袖	xnk
褏	xnkm
褎	xnkn
脩	xnlm
脙	xnln
糔	xnmm
鸺	xnn
鵂	xnnm
嗅	xno
咻	xnob
嚊	xnom
岫	xns
馐	xnsb
饈	xnsm
峀	xnsn
苬	xnum
茠	xnun
修	xnv
休	xnvb
俢	xnvm
珛	xnwm
琇	xnwn
璓	xnwo
羞	xny
鮴	xnym
鱃	xnyn
臭	xnz
貅	xnzb
臹	xnzm
厢	xqc
蟓	xqcb
蚃	xqcm
衖	xqcn
蠁	xqco
忀	xqcp
鬨	xqdm
湘	xqe
潒	xqem
降	xqf
缃	xqfb
鄉	xqfm
緗	xqfn
郷	xqfo
鄊	xqfp
缿	xqfq
鄕	xqfr
絴	xqfs
纕	xqft
庠	xqg
廂	xqgm
相	xqi
橡	xqib
栙	xqim
楿	xqin
欀	xqio
镶	xqj
鑲	xqjm
銄	xqjn
銗	xqjo
鐌	xqjp
箱	xqk
襐	xqkm
勨	xqlm
膷	xqln
勷	xqlo
麘	xqlp
骧	xqm
驤	xqmm
閧	xqmn
闂	xqmo
闀	xqmp
姠	xqnm
向	xqo
响	xqob
啍	xqom
啌	xqon
嚮	xqoo
晑	xqrm
曏	xqrn
象	xqs
祥	xqsb
巷	xqsc
饷	xqsd
飨	xqse
餉	xqsm
饗	xqsn
嶑	xqso
饟	xqsp
享	xqt
襄	xqtb
亯	xqtm
葙	xqu
芗	xqub
薌	xqum
萫	xqun
像	xqv
乡	xqvb
佭	xqvm
儴	xqvn
瓨	xqwm
珦	xqwn
瓖	xqwo
想	xqx
香	xqxb
项	xqy
翔	xqyb
详	xqyc
鲞	xqyd
項	xqym
詳	xqyn
響	xqyo
鯗	xqyp
羏	xqyq
鮝	xqyr
鱌	xqys
鱜	xqyt
鱶	xqyu
夅	xqzm
跭	xqzn
揎	xra
揈	xram
宣	xrb
癣	xrbb
痃	xrbc
癬	xrbm
贙	xrbn
轩	xrc
軒	xrcm
衒	xrcn
蜁	xrco
蝖	xrcp
轋	xrcq
蠉	xrcr
券	xrd
漩	xre
渲	xreb
泫	xrec
旋	xrf
绚	xrfb
絢	xrfm
縣	xrfn
縇	xrfo
颴	xrfp
縼	xrfq
繏	xrfr
弲	xrgm
鞙	xrgn
炫	xrh
煊	xrhb
烜	xrhm
煖	xrhn
楦	xri
梋	xrim
楥	xrin
檈	xrio
铉	xrj
镟	xrjb
鉉	xrjm
鏇	xrjn
鋗	xrjo
鍹	xrjp
鐶	xrjq
袨	xrkm
箮	xrkn
眩	xrm
眴	xrmm
睻	xrmn
駨	xrmo
駽	xrmp
矎	xrmq
妶	xrnm
媗	xrnn
嫙	xrno
嬛	xrnp
喧	xro
吅	xrom
咺	xron
喛	xroo
碹	xrp
狟	xrqm
獧	xrqn
暄	xrr
昍	xrrm
昡	xrrn
晅	xrro
暅	xrrp
暶	xrrq
县	xrs
禤	xrsm
塇	xrtm
萱	xru
萲	xrum
蓒	xrun
蔙	xruo
蕿	xrup
蘐	xruq
藼	xrur
儇	xrv
伭	xrvm
璇	xrw
玹	xrwm
琄	xrwn
琁	xrwo
瑄	xrwp
敻	xrwq
璿	xrwr
玄	xrx
悬	xrxb
懸	xrxm
怰	xrxn
愋	xrxo
愃	xrxp
懁	xrxq
谖	xry
諼	xrym
翧	xryn
諠	xryo
翾	xryp
鰚	xryq
譞	xryr
讂	xrys
选	xrz
選	xrzm
夐	xrzn
匈	xsb
匂	xsbm
賯	xsbn
赨	xscm
兄	xse
汹	xseb
兇	xsem
洶	xsen
熊	xsh
焸	xshm
焽	xshn
熋	xsho
凶	xsk
胸	xsl
胷	xslm
哅	xsom
芎	xsu
敻	xswm
忷	xsxm
恟	xsxn
讻	xsym
诇	xsyn
訩	xsyo
詗	xsyp
詾	xsyq
雄	xsz
夐	xszm
携	xta
挟	xtab
撷	xtac
挾	xtam
攜	xtan
擷	xtao
拹	xtap
揳	xtaq
搚	xtar
擕	xtas
寫	xtbm
卨	xtbn
禼	xtbo
齂	xtbp
蝎	xtc
蟹	xtcb
蠍	xtcm
徢	xtcn
蝢	xtco
齘	xtcp
蠏	xtcq
齛	xtcr
齥	xtcs
斜	xtd
契	xtdb
奊	xtdm
些	xte
泄	xteb
泻	xtec
瀣	xted
渫	xtee
瀉	xtem
洩	xten
滊	xteo
澥	xtep
邪	xtf
缬	xtfb
绁	xtfc
紲	xtfm
纈	xtfn
缷	xtfo
絜	xtfp
絏	xtfq
絬	xtfr
綊	xtfs
緳	xtft
緤	xtfu
縀	xtfv
繲	xtfw
鞋	xtg
廨	xtgb
靾	xtgm
鞢	xtgn
鞵	xtgo
灺	xthm
炧	xthn
炨	xtho
烲	xthp
焎	xthq
熁	xthr
燲	xths
爕	xtht
械	xti
榭	xtib
楔	xtic
榍	xtid
枻	xtim
栧	xtin
梋	xtio
榝	xtip
樧	xtiq
解	xtj
卸	xtjb
觟	xtjm
觧	xtjn
韰	xtjo
褻	xtkm
衺	xtkn
裌	xtko
褉	xtkp
襭	xtkq
胁	xtl
勰	xtlb
脅	xtlm
劦	xtln
脇	xtlo
脋	xtlp
膎	xtlq
写	xtm
冩	xtmm
糏	xtmn
娎	xtnm
媟	xtnn
孈	xtno
叶	xto
吤	xtom
嗋	xton
噧	xtoo
嚡	xtop
屑	xtp
屓	xtpm
屟	xtpn
碿	xtpo
屧	xtpp
屭	xtpq
歇	xtq
獬	xtqb
猲	xtqm
獦	xtqn
旪	xtrm
暬	xtrn
协	xts
協	xtsm
祄	xtsn
峫	xtso
嶰	xtsp
亵	xtt
垥	xttm
塮	xttn
薤	xtu
薢	xtum
藛	xtun
偕	xtv
伳	xtvm
偰	xtvn
偞	xtvo
僁	xtvp
儶	xtvq
瑎	xtwm
韘	xtwn
血	xtx
懈	xtxb
恊	xtxm
慀	xtxn
愶	xtxo
谢	xty
谐	xtyb
颉	xtyc
燮	xtyd
諧	xtym
謝	xtyn
頡	xtyo
鮭	xtyp
翓	xtyq
魼	xtyr
讗	xtys
龤	xtyt
邂	xtz
蹀	xtzb
躞	xtzc
夑	xtzm
躠	xtzn
掝	xuam
揟	xuan
疞	xubm
賉	xubn
鬚	xubo
徐	xuc
蚼	xucm
蛡	xucn
蝑	xuco
殈	xudm
浒	xue
溆	xueb
洫	xuec
漵	xuem
滸	xuen
汿	xueo
沀	xuep
淢	xueq
湏	xuer
湑	xues
滀	xuet
潊	xueu
续	xuf
绪	xufb
絮	xufc
緒	xufm
續	xufn
聓	xufo
続	xufp
綇	xufq
鄦	xufr
聟	xufs
緖	xuft
緰	xufu
縃	xufv
繻	xufw
序	xug
戌	xugb
魆	xugm
魖	xugn
虚	xuh
煦	xuhb
虛	xuhm
烅	xuhn
虗	xuho
烼	xuhp
稰	xuhq
稸	xuhr
燸	xuhs
栩	xui
楈	xuim
槒	xuin
卹	xujm
幁	xujn
銊	xujo
鑐	xujp
裇	xukm
胥	xul
勖	xulb
肷	xulc
胊	xulm
勗	xuln
盱	xum
糈	xumb
眗	xumm
矞	xumn
瞁	xumo
盢	xump
盨	xumq
驉	xumr
婿	xun
姁	xunm
妶	xunn
媭	xuno
嬃	xunp
吁	xuo
嘘	xuob
噓	xuom
呴	xuon
喐	xuoo
喣	xuop
嘼	xuoq
砉	xup
酗	xuq
醑	xuqb
欨	xuqm
欰	xuqn
欻	xuqo
歔	xuqp
獝	xuqq
歘	xuqr
需	xur
旭	xurb
旴	xurm
昫	xurn
晇	xuro
朂	xurp
暊	xurq
壻	xusm
禑	xusn
畜	xut
墟	xutb
圩	xutc
垿	xutm
冔	xutn
蓄	xuu
蓿	xuub
芧	xuum
蒣	xuun
蓲	xuuo
蕦	xuup
藇	xuuq
藚	xuur
伵	xuvm
侐	xuvn
俆	xuvo
偦	xuvp
敘	xuwm
珬	xuwn
珝	xuwo
敍	xuwp
恤	xux
怴	xuxm
恓	xuxn
惐	xuxo
慉	xuxp
窢	xuxq
许	xuy
须	xuyb
叙	xuyc
诩	xuyd
顼	xuye
許	xuym
須	xuyn
頊	xuyo
詡	xuyp
謳	xuyq
訏	xuyr
谞	xuys
訹	xuyt
魣	xuyu
諿	xuyv
諝	xuyw
譃	xuyx
鱮	xuyy
捾	xwam
疜	xwbm
疨	xwbn
厦	xwc
辖	xwcb
虾	xwcc
蝦	xwcm
轄	xwcn
徦	xwco
赮	xwcp
螛	xwcq
夾	xwdm
浹	xwem
匣	xwf
罅	xwfb
陜	xwfm
陿	xwfn
颬	xwfo
縖	xwfp
廈	xwgm
谺	xwgn
下	xwh
黠	xwhb
煆	xwhm
丅	xwhn
炠	xwho
烚	xwhp
柙	xwi
梺	xwim
鍜	xwjm
鎼	xwjn
鎋	xwjo
鏬	xwjp
笚	xwkm
筪	xwkn
瞎	xwm
閕	xwmm
閜	xwmn
睱	xwmo
騢	xwmp
鶷	xwnm
吓	xwo
唬	xwob
呷	xwoc
嚇	xwom
硖	xwp
硤	xwpm
碬	xwpn
磍	xwpo
狭	xwq
狎	xwqb
狹	xwqm
欱	xwqn
猇	xwqo
霞	xwr
暇	xwrb
昰	xwrm
峡	xws
峽	xwsm
祫	xwsn
圷	xwtm
埉	xwtn
芐	xwum
蕸	xwun
侠	xwv
俠	xwvm
傄	xwvn
瑕	xww
珨	xwwm
敮	xwwn
舝	xwwo
懗	xwxm
叚	xwym
翈	xwyn
諕	xwyo
魻	xwyp
謑	xwyq
鰕	xwyr
夏	xwz
遐	xwzb
舺	xwzm
夓	xwzn
撢	xxam
寻	xxc
軐	xxcm
潃	xxem
阠	xxfm
邤	xxfn
庍	xxgm
廞	xxgn
鬵	xxgo
炘	xxhm
焮	xxhn
枔	xxim
杺	xxin
橝	xxio
新	xxj
鑫	xxjb
锌	xxjc
镡	xxje
鋅	xxjm
鐔	xxjn
鈊	xxjo
舋	xxjp
襑	xxkm
脪	xxlm
盺	xxmm
馸	xxmn
妡	xxnm
嬜	xxnn
噺	xxom
噷	xxon
囟	xxp
礥	xxpm
欣	xxq
歆	xxqb
釁	xxqm
昕	xxr
薪	xxu
芯	xxub
莘	xxuc
信	xxv
伩	xxvm
伈	xxvn
俽	xxvo
心	xxx
辛	xxxb
馨	xxxc
衅	xxxd
忻	xxxe
忄	xxxf
惞	xxxm
愖	xxxn
馫	xxxo
訢	xxym
訫	xxyn
顖	xxyo
孞	xxzm
擤	xya
兴	xyb
皨	xybm
行	xyc
巠	xycm
蛵	xycn
刑	xyd
滎	xyem
洐	xyen
涬	xyeo
邢	xyf
陉	xyfb
陘	xyfm
郉	xyfn
緈	xyfo
煋	xyhm
杏	xyi
興	xyjm
钘	xyjn
铏	xyjo
鈃	xyjp
銒	xyjq
鉶	xyjr
觪	xyjs
鋞	xyjt
觲	xyju
裄	xykm
箵	xykn
篂	xyko
腥	xyl
臖	xylm
省	xym
骍	xymm
睲	xymn
騂	xymo
姓	xyn
娙	xynm
婞	xynn
嬹	xyno
哘	xyom
硎	xyp
醒	xyq
猩	xyqb
狌	xyqm
星	xyr
曐	xyrm
形	xys
饧	xysb
餳	xysm
幸	xyt
型	xytb
坙	xytm
垶	xytn
荥	xyu
荇	xyub
莕	xyum
葕	xyun
侀	xyvm
倖	xyvn
瑆	xywm
性	xyx
惺	xyxb
悻	xyxc
鮏	xyym
謃	xyyn
鯹	xyyo
隵	xzfw
酅	xzfx
飁	xzfy
纚	xzfz
鏭	xzjr
鐊	xzjs
觹	xzjt
觽	xzju
觿	xzjv
鑴	xzjw
幰	xzjx
鏾	xzjy
鑦	xzjz
鷳	xznz
押	yaa
揠	yaab
拁	yaam
挜	yaan
掗	yaao
痖	yab
瘂	yabm
冴	yabn
疨	yabo
压	yac
衙	yacb
轧	yacc
蚜	yacd
軋	yacm
厭	yacn
輅	yaco
厊	yacp
厑	yacq
厓	yacr
輵	yacs
齖	yact
齾	yacu
涯	yae
漄	yaem
潝	yaen
聐	yafm
庌	yagm
庘	yagn
亚	yah
亞	yahm
亜	yahn
稏	yaho
桠	yai
椏	yaim
枒	yain
椻	yaio
铔	yajm
釾	yajn
錏	yajo
鐚	yajp
笌	yakm
丫	yal
劜	yalm
睚	yam
鸭	yan
鸦	yanb
娅	yanc
鴉	yanm
鴨	yann
婭	yano
姶	yanp
鵶	yanq
呀	yao
哑	yaob
吖	yaoc
啞	yaom
呾	yaon
唖	yaoo
砑	yap
磍	yapm
氩	yaq
氬	yaqm
犽	yaqn
猚	yaqo
猰	yaqp
崖	yas
岈	yasb
崕	yasm
垭	yat
壓	yatm
埡	yatn
圠	yato
圧	yatp
堐	yatq
芽	yau
蕥	yaum
伢	yav
俹	yavm
琊	yaw
玡	yawm
圔	yawn
瓛	yawo
襾	yaxm
覀	yaxn
穵	yaxo
窫	yaxp
牙	yay
讶	yayb
訝	yaym
雅	yaz
迓	yazb
疋	yazc
孲	yazm
摇	yca
搖	ycam
抭	ycan
揺	ycao
摿	ycap
撽	ycaq
疟	ycb
瘧	ycbm
宎	ycbn
匋	ycbo
皐	ycbp
鼼	ycbq
徭	ycc
轺	yccb
軺	yccm
徺	yccn
齩	ycco
夭	ycd
殀	ycdm
滧	ycem
溔	ycen
约	ycf
陶	ycfb
繇	ycfc
約	ycfm
隃	ycfn
飖	ycfo
颻	ycfp
纅	ycfq
靿	ycgm
烑	ychm
烄	ychn
熎	ycho
燿	ychp
杳	yci
枖	ycim
柼	ycin
楆	ycio
榣	ycip
榚	yciq
钥	ycj
舀	ycjb
铫	ycjc
鑰	ycjm
銚	ycjn
覞	ycjo
鎐	ycjp
袎	yckm
筄	yckn
箹	ycko
腰	ycl
肴	yclb
麽	ycm
驁	ycmm
眑	ycmn
闄	ycmo
騕	ycmp
矅	ycmq
妖	ycn
姚	ycnb
鹞	ycnc
鷂	ycnm
婹	ycnn
媱	ycno
鴁	ycnp
鴢	ycnq
鷕	ycnr
咬	yco
吆	ycob
喓	ycom
嗂	ycon
噛	ycoo
么	ycp
殽	ycpm
磘	ycpn
狕	ycqm
猺	ycqn
獟	ycqo
曜	ycr
暚	ycrm
曣	ycrn
崾	ycs
岆	ycsm
祅	ycsn
峣	ycso
餆	ycsp
嶢	ycsq
嶤	ycsr
餚	ycss
堯	yctm
垚	yctn
药	ycu
藥	ycum
蕘	ycun
苭	ycuo
葽	ycup
葯	ycuq
蓔	ycur
薬	ycus
蘨	ycut
侥	ycv
僥	ycvm
仸	ycvn
倄	ycvo
偠	ycvp
傜	ycvq
瑶	ycw
尧	ycwb
珧	ycwc
瑤	ycwm
尭	ycwn
要	ycx
窑	ycxb
窈	ycxc
爻	ycxd
窯	ycxm
怮	ycxn
玅	ycxo
恌	ycxp
穾	ycxq
窅	ycxr
窔	ycxs
愮	ycxt
窰	ycxu
耀	ycy
谣	ycyb
幺	ycyc
鳐	ycyd
謠	ycym
鰩	ycyn
訞	ycyo
詏	ycyp
謡	ycyq
顤	ycyr
鱙	ycys
讑	ycyt
遥	ycz
邀	yczb
遙	yczm
艞	yczn
邎	yczo
拽	yea
揶	yeab
掖	yeac
揲	yead
抴	yeam
捓	yean
捙	yeao
擛	yeap
擖	yeaq
擫	year
擨	yeas
擪	yeat
冶	yeb
痷	yebm
皣	yebn
靥	yec
蠮	yecm
殗	yedm
殕	yedn
液	yee
洂	yeem
漜	yeen
潱	yeeo
澲	yeep
爷	yef
耶	yefb
邪	yefc
邺	yefd
爺	yefm
鄴	yefn
緤	yefo
烨	yeh
燁	yehm
焆	yehn
煠	yeho
熀	yehp
爗	yehq
椰	yei
業	yeim
枒	yein
枼	yeio
枽	yeip
楪	yeiq
铘	yej
鋣	yejm
釾	yejn
鎁	yejo
鍱	yejp
鎑	yejq
鐷	yejr
野	yel
曳	yelb
腋	yelc
靨	yemm
瞱	yemn
瞸	yemo
驜	yemp
鵺	yenm
鸈	yenn
叶	yeo
咽	yeob
噎	yeoc
吔	yeom
嘢	yeon
嚥	yeoo
礏	yepm
歋	yeqm
晔	yer
曄	yerm
曵	yern
暍	yero
曅	yerp
曗	yerq
峫	yesm
馌	yesn
嶪	yeso
嶫	yesp
餣	yesq
饁	yesr
亪	yetm
亱	yetn
埜	yeto
堨	yetp
墷	yetq
壄	yetr
葉	yeum
也	yev
倻	yevm
僷	yevn
瑘	yewm
璍	yewn
瓛	yewo
夜	yex
窫	yexm
业	yey
页	yeyb
谒	yeyc
頁	yeym
謁	yeyn
揂	yfam
宥	yfb
疣	yfbb
卣	yfbc
痏	yfbm
釉	yfc
蝣	yfcb
蚰	yfcc
蚴	yfcd
蝤	yfce
蚘	yfcm
蜏	yfcn
輏	yfco
輶	yfcp
游	yfe
油	yfeb
沋	yfem
汼	yfen
泑	yfeo
浟	yfep
湵	yfeq
滺	yfer
瀀	yfes
邮	yff
繇	yffb
郵	yffm
斿	yffn
聈	yffo
鄾	yffp
纋	yffq
庮	yfgm
戭	yfgn
黝	yfh
丣	yfhm
秞	yfhn
柚	yfi
栯	yfim
梄	yfin
梎	yfio
楢	yfip
槱	yfiq
櫌	yfir
櫾	yfis
铀	yfj
铕	yfjb
鈾	yfjm
銹	yfjn
銪	yfjo
褏	yfkm
褎	yfkn
有	yfl
肬	yflm
麀	yfln
耰	yflo
冘	yfmm
駀	yfmn
妋	yfnm
牰	yfnn
姷	yfno
右	yfo
呦	yfob
哊	yfom
唀	yfon
嚘	yfoo
牖	yfp
牗	yfpm
犹	yfq
猷	yfqb
酉	yfqc
猶	yfqm
狖	yfqn
酭	yfqo
獶	yfqp
獿	yfqq
幽	yfs
鼬	yfsb
峟	yfsm
祐	yfsn
峳	yfso
禉	yfsp
由	yft
甴	yftm
亴	yftn
莜	yfu
莠	yfub
莸	yfuc
蕕	yfum
苃	yfun
莤	yfuo
蒏	yfup
优	yfv
佑	yfvb
攸	yfvc
侑	yfvd
優	yfvm
偤	yfvn
囿	yfw
悠	yfx
忧	yfxb
憂	yfxm
怞	yfxn
怮	yfxo
怣	yfxp
懮	yfxq
又	yfy
友	yfyb
尤	yfyc
诱	yfyd
幼	yfye
鱿	yfyf
尢	yfyg
誘	yfym
魷	yfyn
羑	yfyo
訧	yfyp
鲉	yfyq
羪	yfyr
鮋	yfys
遊	yfzm
孧	yfzn
迶	yfzo
逌	yfzp
逰	yfzq
貁	yfzr
邎	yfzs
扚	ygam
抈	ygan
捳	ygao
擽	ygap
兌	ygbm
髺	ygbn
蛻	ygcm
軏	ygcn
蚎	ygco
蚏	ygcp
刖	ygd
瀹	yge
兊	ygem
泧	ygen
约	ygf
約	ygfm
戉	yggm
焆	yghm
黦	yghn
爚	ygho
栎	ygi
樾	ygib
樂	ygim
櫟	ygin
枂	ygio
楽	ygip
钥	ygj
钺	ygjb
鑰	ygjm
鉞	ygjn
鑠	ygjo
鈅	ygjp
鋭	ygjq
箹	ygkm
篗	ygkn
籆	ygko
籥	ygkp
籰	ygkq
月	ygl
臒	yglm
阅	ygm
粤	ygmb
粵	ygmm
閱	ygmn
閲	ygmo
矆	ygmp
妜	ygnm
嬳	ygnn
鸑	ygno
鸙	ygnp
哕	ygo
噦	ygom
哾	ygon
啘	ygoo
乐	ygp
曰	ygr
曱	ygrm
岳	ygs
嶽	ygsm
岄	ygsn
礿	ygso
矱	ygsp
禴	ygsq
藥	ygum
蘥	ygun
玥	ygwm
悦	ygx
悅	ygxm
恱	ygxn
说	ygy
龠	ygyb
說	ygym
説	ygyn
龥	ygyo
越	ygz
跃	ygzb
躍	ygzm
躒	ygzn
跀	ygzo
趯	ygzp
扬	yha
揚	yham
抰	yhan
攁	yhao
养	yhb
痒	yhbb
疡	yhbc
瘍	yhbm
癢	yhbn
徉	yhc
蛘	yhcb
軮	yhcm
蝆	yhcn
輰	yhco
央	yhd
殃	yhdb
洋	yhe
漾	yheb
泱	yhec
潒	yhem
瀁	yhen
阳	yhf
陽	yhfm
阦	yhfn
飏	yhfo
紻	yhfp
颺	yhfq
鞅	yhg
炀	yhh
秧	yhhb
烊	yhhc
煬	yhhm
炴	yhhn
样	yhi
杨	yhib
楊	yhim
樣	yhin
柍	yhio
楧	yhip
様	yhiq
卬	yhjm
钖	yhjn
锳	yhjo
鉠	yhjp
鍈	yhjq
鍚	yhjr
鐊	yhjs
劷	yhlm
胦	yhln
勜	yhlo
眏	yhmm
眻	yhmn
駚	yhmo
鸯	yhn
鴦	yhnm
姎	yhnn
婸	yhno
鴹	yhnp
鸉	yhnq
咉	yhom
礢	yhpm
氧	yhq
氜	yhqm
氱	yhqn
歍	yhqo
旸	yhrm
昜	yhrn
雵	yhro
暘	yhrp
霷	yhrq
養	yhsm
岟	yhsn
崸	yhso
崵	yhsp
飬	yhsq
禓	yhsr
坱	yhtm
垟	yhtn
仰	yhv
佯	yhvb
佒	yhvm
傟	yhvn
玚	yhwm
珜	yhwn
瑒	yhwo
敭	yhwp
恙	yhx
怏	yhxb
愓	yhxm
慃	yhxn
懩	yhxo
羊	yhy
詳	yhym
羏	yhyn
羕	yhyo
詇	yhyp
諹	yhyq
鰑	yhyr
抑	yia
揖	yiab
挹	yiac
扡	yiam
拸	yian
掜	yiao
搤	yiap
撎	yiaq
疑	yib
宜	yibb
疫	yibc
贻	yibd
痍	yibe
肄	yibf
癔	yibg
瘗	yibh
貽	yibm
瘞	yibn
匇	yibo
宐	yibp
貤	yibq
宧	yibr
痬	yibs
兿	yibt
瘱	yibu
賹	yibv
寲	yibw
寱	yibx
贀	yiby
役	yic
蚁	yicb
蜴	yicc
轶	yicd
蛇	yice
蟻	yicm
軼	yicn
彵	yico
虵	yicp
蛦	yicq
蛜	yicr
蛡	yics
輢	yict
輗	yicu
螘	yicv
螔	yicw
螠	yicx
轙	yicy
齮	yicz
义	yid
夷	yidb
奕	yidc
刈	yidd
劓	yide
殪	yidf
殔	yidm
已	yie
溢	yieb
漪	yiec
沂	yied
沶	yiem
泆	yien
洟	yieo
洩	yiep
洢	yieq
浂	yier
浳	yies
浥	yiet
渏	yieu
湙	yiev
潩	yiew
澺	yiex
瀷	yiey
医	yif
绎	yifb
旖	yifc
缢	yifd
繹	yifm
紲	yifn
縊	yifo
匜	yifp
阣	yifq
耴	yifr
陭	yifs
郼	yift
鄓	yifu
旑	yifv
絏	yifw
繄	yifx
繶	yify
异	yig
羿	yigb
弈	yigc
庡	yigm
弬	yign
骮	yigo
靾	yigp
廙	yigq
一	yih
移	yihb
熠	yihc
黟	yihd
戺	yihm
秇	yihn
炈	yiho
扅	yihp
扆	yihq
焬	yihr
焲	yihs
煕	yiht
稦	yihu
熈	yihv
黓	yihw
熼	yihx
熪	yihy
熤	yihz
椅	yii
杙	yiim
杝	yiin
枍	yiio
枻	yiip
柂	yiiq
桋	yiir
栧	yiis
栺	yiit
栘	yiiu
棭	yiiv
椬	yiiw
椸	yiix
榏	yiiy
槷	yiiz
镒	yij
铱	yijb
镱	yijc
钇	yijd
銥	yijm
釔	yijn
鎰	yijo
鐿	yijp
帠	yijq
帟	yijr
釴	yijs
釶	yijt
幆	yiju
鈘	yijv
鈠	yijw
鉯	yijx
銕	yijy
錡	yijz
衣	yik
裔	yikb
衤	yikc
衪	yikm
衵	yikn
笖	yiko
袣	yikp
袘	yikq
裛	yikr
裿	yiks
褘	yikt
篒	yiku
箷	yikv
褹	yikw
簃	yikx
籎	yiky
襼	yikz
翌	yil
翊	yilb
臆	yilc
胰	yild
肊	yilm
劮	yiln
耛	yilo
勚	yilp
竩	yilq
勩	yilr
膉	yils
益	yim
驿	yimb
眙	yimc
睪	yimm
驛	yimn
冝	yimo
駅	yimp
瞖	yimq
姨	yin
乁	yinm
妷	yinn
鳦	yino
媐	yinp
嫛	yinq
嫕	yinr
鹝	yins
鹢	yint
嬄	yinu
鹥	yinv
嬑	yinw
嬟	yinx
鴺	yiny
鶍	yinz
咦	yio
邑	yiob
呓	yioc
咿	yiod
噫	yioe
嗌	yiof
囈	yiom
吚	yion
呭	yioo
呹	yiop
唈	yioq
毅	yip
尾	yipb
殹	yipm
毉	yipn
礒	yipo
欹	yiq
猗	yiqb
酏	yiqc
醫	yiqm
欥	yiqn
狋	yiqo
狏	yiqp
欭	yiqq
獈	yiqr
歖	yiqs
歝	yiqt
醳	yiqu
醷	yiqv
易	yir
曵	yirm
昳	yirn
晹	yiro
暆	yirp
曀	yirq
曎	yirr
霬	yirs
靉	yirt
矣	yis
屹	yisb
壹	yisc
嶷	yisd
饴	yise
峄	yisf
飴	yism
嶧	yisn
壱	yiso
祎	yisp
峓	yisq
巸	yisr
豛	yiss
豙	yist
崺	yisu
禕	yisv
叆	yisw
夁	yisx
嶬	yisy
豷	yisz
亦	yit
圯	yitb
埸	yitc
異	yitm
坄	yitn
垼	yito
埶	yitp
畩	yitq
墿	yitr
艺	yiu
艾	yiub
荑	yiuc
苡	yiud
薏	yiue
藝	yium
芅	yiun
苅	yiuo
苢	yiup
萟	yiuq
萓	yiur
蓺	yius
藙	yiut
蘙	yiuu
虉	yiuv
以	yiv
依	yivb
伊	yivc
仪	yivd
亿	yive
乙	yivf
倚	yivg
佚	yivh
佾	yivi
仡	yivj
億	yivm
儀	yivn
乚	yivo
伇	yivp
伿	yivq
佁	yivr
侇	yivs
俋	yivt
偯	yivu
亄	yivv
儗	yivw
攺	yiwm
玴	yiwn
珆	yiwo
瓵	yiwp
敧	yiwq
敡	yiwr
敼	yiws
瑿	yiwt
圛	yiwu
斁	yiwv
意	yix
忆	yixb
怡	yixc
懿	yixd
彝	yixe
悒	yixf
怿	yixg
憶	yixm
彜	yixn
懌	yixo
乂	yixp
忔	yixq
怈	yixr
恞	yixs
悘	yixt
悥	yixu
彛	yixv
懝	yixw
彞	yixx
议	yiy
翼	yiyb
译	yiyc
谊	yiyd
诣	yiye
颐	yiyf
弋	yiyg
翳	yiyh
诒	yiyi
詣	yiym
義	yiyn
誼	yiyo
頤	yiyp
譯	yiyq
議	yiyr
詒	yiys
誒	yiyt
謚	yiyu
弌	yiyv
叕	yiyw
訑	yiyx
訲	yiyy
訳	yiyz
遗	yiz
逸	yizb
迤	yizc
舣	yizd
遺	yizm
艤	yizn
辷	yizo
迆	yizp
迱	yizq
迻	yizr
逘	yizs
隿	yizt
攲	yizu
跇	yizv
跠	yizw
踦	yizx
艗	yizy
貖	yizz
抎	ykam
抣	ykan
匀	ykb
勻	ykbm
疺	ykbn
貟	ykbo
賱	ykbp
赟	ykbq
贇	ykbr
蝹	ykcm
蜵	ykcn
轀	ykco
齫	ykcp
齳	ykcq
殒	ykd
殞	ykdm
夽	ykdn
奫	ykdo
允	yke
沄	ykem
涢	yken
涒	ykeo
溳	ykep
澐	ykeq
陨	ykf
纭	ykfb
郓	ykfc
郧	ykfd
鄖	ykfm
隕	ykfn
紜	ykfo
鄆	ykfp
阭	ykfq
耺	ykfr
缊	ykfs
緼	ykft
緷	ykfu
縜	ykfv
縕	ykfw
繧	ykfx
鞰	ykgm
云	ykh
熨	ykhb
秐	ykhm
煴	ykhn
煇	ykho
熉	ykhp
煾	ykhq
熅	ykhr
枟	ykim
榅	ykin
橒	ykio
鈗	ykjm
鋆	ykjn
筠	ykk
筼	ykkm
褞	ykkn
篔	ykko
耘	ykl
腪	yklm
眃	ykmm
馻	ykmn
媼	yknm
妘	yknn
员	yko
員	ykom
喗	ykon
磒	ykpm
酝	ykq
氲	ykqb
狁	ykqc
醞	ykqm
氳	ykqn
醖	ykqo
晕	ykr
昀	ykrb
雲	ykrm
暈	ykrn
霣	ykro
餫	yksm
畇	yktm
芸	yku
蕴	ykub
蘊	ykum
蕓	ykun
荺	ykuo
蒀	ykup
蒷	ykuq
蒕	ykur
蕰	ykus
薀	ykut
藴	ykuu
伝	ykvm
傊	ykvn
韫	ykw
韞	ykwm
囩	ykwn
玧	ykwo
韗	ykwp
愠	ykx
恽	ykxb
惲	ykxm
慍	ykxn
愪	ykxo
馧	ykxp
韵	yky
韻	ykym
頵	ykyn
运	ykz
孕	ykzb
運	ykzm
掩	yla
抁	ylam
挻	ylan
挩	ylao
掞	ylap
揜	ylaq
揅	ylar
宴	ylb
赝	ylbb
贗	ylbm
贋	ylbn
厌	ylc
衍	ylcb
蜒	ylcc
厣	ylcd
厭	ylcm
厴	ylcn
蝘	ylco
厳	ylcp
齞	ylcq
齴	ylcr
奄	yld
剡	yldb
夵	yldm
剦	yldn
殗	yldo
演	yle
沿	yleb
淹	ylec
湮	yled
滟	ylee
灩	ylem
沇	ylen
洝	yleo
淊	ylep
湺	yleq
渰	yler
渷	yles
溎	ylet
漹	yleu
灔	ylev
灎	ylew
灧	ylex
鄢	ylf
郾	ylfb
阽	ylfc
郔	ylfm
匽	ylfn
隁	ylfo
隒	ylfp
綖	ylfq
縯	ylfr
酀	ylfs
豓	ylft
豔	ylfu
魇	ylg
魘	ylgm
弇	ylgn
戭	ylgo
鬳	ylgp
严	ylh
烟	ylhb
焰	ylhc
炎	ylhd
燕	ylhe
焉	ylhf
焱	ylhg
煙	ylhm
炏	ylhn
烻	ylho
焔	ylhp
扊	ylhq
熖	ylhr
虤	ylhs
燄	ylht
黡	ylhu
黤	ylhv
爓	ylhw
黫	ylhx
黬	ylhy
黭	ylhz
檐	yli
梴	ylim
棪	ylin
椻	ylio
椼	ylip
楌	yliq
樮	ylir
橪	ylis
檿	ylit
櫩	yliu
欕	yliv
铅	ylj
鉛	yljm
錟	yljn
觃	yljo
覎	yljp
觾	yljq
筵	ylk
裺	ylkm
褗	ylkn
篶	ylko
簷	ylkp
胭	yll
腌	yllb
鹽	yllm
臙	ylln
麙	yllo
龑	yllp
麣	yllq
眼	ylm
验	ylmb
阎	ylmc
盐	ylmd
阉	ylme
闫	ylmf
阏	ylmg
閹	ylmm
閻	ylmn
驗	ylmo
閆	ylmp
閼	ylmq
験	ylmr
騐	ylms
騴	ylmt
驠	ylmu
嫣	yln
妍	ylnb
妟	ylnm
牪	ylnn
姸	ylno
娫	ylnp
姲	ylnq
娮	ylnr
媕	ylns
鳫	ylnt
鳱	ylnu
嬊	ylnv
鴈	ylnw
嬐	ylnx
嬮	ylny
鴳	ylnz
咽	ylo
唁	ylob
嚴	ylom
唌	ylon
啱	yloo
喦	ylop
喭	yloq
噞	ylor
嚈	ylos
嚥	ylot
囐	ylou
研	ylp
殷	ylpb
砚	ylpc
硯	ylpm
硏	ylpn
硽	ylpo
碞	ylpp
礹	ylpq
酽	ylq
釅	ylqm
狿	ylqn
酓	ylqo
猏	ylqp
猒	ylqq
歅	ylqr
醃	ylqs
醶	ylqt
醼	ylqu
晏	ylr
昖	ylrm
晻	ylrn
暥	ylro
曕	ylrp
曣	ylrq
曮	ylrr
艳	yls
岩	ylsb
彦	ylsc
鼹	ylsd
罨	ylse
餍	ylsf
崦	ylsg
彥	ylsm
巖	ylsn
艷	ylso
鼴	ylsp
饜	ylsq
豜	ylsr
嵒	ylss
嵓	ylst
嵃	ylsu
嵼	ylsv
嶖	ylsw
嶮	ylsx
躽	ylsy
艶	ylsz
兖	ylt
堰	yltb
埏	yltc
兗	yltm
円	yltn
塩	ylto
墕	yltp
壛	yltq
壧	yltr
芫	ylu
菸	ylub
薟	ylum
莚	ylun
菴	yluo
萒	ylup
蔅	yluq
俨	ylv
偃	ylvb
儼	ylvm
乵	ylvn
偣	ylvo
偐	ylvp
傿	ylvq
琰	ylw
珚	ylwm
琂	ylwn
敥	ylwo
甗	ylwp
恹	ylx
懨	ylxm
愝	ylxn
窴	ylxo
懕	ylxp
言	yly
颜	ylyb
延	ylyc
谚	ylyd
谳	ylye
讠	ylyf
諺	ylym
顏	ylyn
訁	ylyo
讞	ylyp
訮	ylyq
詽	ylyr
羬	ylys
顔	ylyt
鰋	ylyu
顩	ylyv
讌	ylyw
雁	ylz
趼	ylzb
遃	ylzm
哟	yoo
唷	yoob
喲	yoom
喻	you
援	yra
掾	yrab
贠	yrbm
貟	yrbn
寃	yrbo
原	yrc
辕	yrcb
螈	yrcc
轅	yrcm
蚖	yrcn
衏	yrco
厡	yrcp
蜎	yrcq
輐	yrcr
蜵	yrcs
蝯	yrct
蝝	yrcu
厵	yrcv
剈	yrdm
源	yre
渊	yreb
沅	yrec
淵	yrem
渁	yren
渆	yreo
渕	yrep
涴	yreq
湲	yrer
溒	yres
灁	yret
院	yrf
缘	yrfb
緣	yrfm
邧	yrfn
縁	yrfo
弲	yrgm
鼘	yrgn
鼝	yrgo
元	yrh
橼	yri
櫞	yrim
杬	yrin
棩	yrio
楥	yrip
榬	yriq
榞	yrir
鈨	yrjm
鋺	yrjn
鎱	yrjo
箢	yrk
笎	yrkm
裷	yrkn
裫	yrko
褑	yrkp
褤	yrkq
肙	yrlm
冤	yrm
鼋	yrmb
眢	yrmc
黿	yrmm
盶	yrmn
駌	yrmo
騵	yrmp
媛	yrn
鸳	yrnb
鸢	yrnc
鴛	yrnm
鳶	yrnn
妧	yrno
妴	yrnp
鹓	yrnq
媴	yrnr
嫄	yrns
鵷	yrnt
嬽	yrnu
鶢	yrnv
鶰	yrnw
员	yro
員	yrom
喛	yron
噮	yroo
猿	yrq
酛	yrqm
猨	yrqn
獂	yrqo
禐	yrsm
袁	yrt
垣	yrtb
塬	yrtc
垸	yrtd
円	yrtm
苑	yru
芫	yrub
茒	yrum
葾	yrun
蒝	yruo
蒬	yrup
薳	yruq
薗	yrur
傆	yrvm
圆	yrw
园	yrwb
圜	yrwc
瑗	yrwd
園	yrwm
圓	yrwn
囦	yrwo
圎	yrwp
愿	yrx
怨	yrxb
夗	yrxm
悁	yrxn
惌	yrxo
願	yrym
魭	yryn
羱	yryo
謜	yryp
远	yrz
爰	yrzb
遠	yrzm
逺	yrzn
邍	yrzo
拥	ysa
擁	ysam
揘	ysan
痈	ysb
癰	ysbm
癕	ysbn
蛹	ysc
邕	yscb
永	yse
涌	yseb
泳	ysec
湧	ysem
滽	ysen
澭	yseo
灉	ysep
鄘	ysfm
郺	ysfn
庸	ysg
廱	ysgm
栐	ysim
柡	ysin
槦	ysio
镛	ysj
鏞	ysjm
銿	ysjn
筩	yskm
勇	ysl
臃	yslb
勈	yslm
嫞	ysnm
鷛	ysnn
咏	yso
喁	ysob
嗈	ysom
噰	yson
砽	yspm
硧	yspn
牗	yspo
牅	yspp
醟	ysqm
饔	yss
嵱	yssm
彮	yssn
禜	ysso
雍	yst
墉	ystb
壅	ystc
埇	ystm
塎	ystn
苚	ysum
蒏	ysun
佣	ysv
俑	ysvb
傭	ysvm
傛	ysvn
慵	ysx
恿	ysxb
怺	ysxm
悀	ysxn
惥	ysxo
愑	ysxp
愹	ysxq
慂	ysxr
用	ysy
甬	ysyb
鳙	ysyc
詠	ysym
鱅	ysyn
颙	ysyo
鲬	ysyp
顒	ysyq
鯒	ysyr
鰫	ysys
踊	ysz
踴	yszm
雝	yszn
揄	yua
扜	yuam
扝	yuan
扵	yuao
捓	yuap
挧	yuaq
捥	yuar
宇	yub
寓	yubb
舆	yubc
瘀	yubd
瘐	yube
痏	yubm
寙	yubn
瘉	yubo
癒	yubp
御	yuc
尉	yucb
蜮	yucc
蝓	yucd
龉	yuce
輿	yucm
蟈	yucn
齬	yuco
虶	yucp
輍	yucq
蜟	yucr
蝺	yucs
螸	yuct
轝	yucu
齵	yucv
奧	yudm
斞	yudn
浴	yue
渔	yueb
淤	yuec
渝	yued
漁	yuem
汚	yuen
淢	yueo
淯	yuep
湡	yueq
滪	yuer
潏	yues
澞	yuet
澦	yueu
灪	yuev
郁	yuf
於	yufb
隅	yufc
纡	yufd
紆	yufm
邘	yufn
陓	yufo
匬	yufp
鄅	yufq
隃	yufr
旕	yufs
隩	yuft
緎	yufu
繘	yufv
旟	yufw
谷	yug
庾	yugb
鬻	yugc
骬	yugm
庽	yugn
戫	yugo
魊	yugp
髃	yugq
于	yuh
与	yuhb
虞	yuhc
煜	yuhd
熨	yuhe
燠	yuhf
丂	yuhm
亐	yuhn
灹	yuho
秗	yuhp
焴	yuhq
稢	yuhr
穀	yuhs
稶	yuht
燏	yuhu
燰	yuhv
穥	yuhw
爩	yuhx
榆	yui
杅	yuim
栯	yuin
桙	yuio
棫	yuip
楰	yuiq
棜	yuir
棛	yuis
楀	yuit
楡	yuiu
櫲	yuiv
欎	yuiw
欝	yuix
鬰	yuiy
鬱	yuiz
钰	yuj
臾	yujb
觎	yujc
舁	yujd
與	yujm
鈺	yujn
覦	yujo
釪	yujp
铻	yujq
銉	yujr
鋙	yujs
鋊	yujt
錥	yuju
鍝	yujv
鐭	yujw
裕	yuk
竽	yukb
籲	yukm
衧	yukn
袬	yuko
箊	yukp
褕	yukq
篽	yukr
籅	yuks
籞	yukt
育	yul
腴	yulb
禺	yulc
麌	yulm
驭	yum
粥	yumb
毓	yumc
盂	yumd
阈	yume
馭	yumm
閾	yumn
閼	yumo
粖	yump
盓	yumq
矞	yumr
睮	yums
騟	yumt
驈	yumu
娱	yun
妤	yunb
妪	yunc
鹬	yund
鹆	yune
娛	yunm
嫗	yunn
鵒	yuno
鷸	yunp
娪	yunq
娯	yunr
媀	yuns
媮	yunt
婾	yunu
鳿	yunv
鴥	yunw
鴪	yunx
鴧	yuny
嬩	yunz
吁	yuob
喁	yuoc
唹	yuom
喅	yuon
喩	yuoo
噊	yuop
噳	yuoq
禹	yup
丿	yupb
砡	yupm
硢	yupn
硲	yupo
牏	yupp
礇	yupq
礖	yupr
礜	yups
欲	yuq
狱	yuqb
狳	yuqc
欤	yuqd
獄	yuqm
歟	yuqn
欥	yuqo
酑	yuqp
歈	yuqq
獝	yuqr
醧	yuqs
雨	yur
昱	yurb
雩	yurc
兪	yurm
霱	yurn
豫	yus
屿	yusb
馀	yusc
峪	yusd
嵛	yuse
饫	yusf
嶼	yusm
禦	yusn
崳	yuso
飫	yusp
餘	yusq
彧	yusr
峿	yuss
祤	yust
嵎	yusu
罭	yusv
嶎	yusw
饇	yusx
軉	yusy
域	yut
畲	yutb
畬	yutm
圫	yutn
堉	yuto
堣	yutp
堬	yutq
畭	yutr
芋	yuu
蔚	yuub
菸	yuuc
蓣	yuud
萸	yuue
蕷	yuum
芌	yuun
茰	yuuo
荢	yuup
茟	yuuq
萭	yuur
萮	yuus
蒮	yuut
薁	yuuu
蓹	yuuv
蕍	yuuw
藇	yuux
蘛	yuuy
蘌	yuuz
余	yuv
予	yuvb
俞	yuvc
俣	yuvd
伛	yuve
俁	yuvm
傴	yuvn
伃	yuvo
俼	yuvp
偊	yuvq
僪	yuvr
儥	yuvs
玉	yuw
瑜	yuwb
圉	yuwc
圄	yuwd
玗	yuwm
玙	yuwn
敔	yuwo
琙	yuwp
琟	yuwq
瑀	yuwr
璵	yuws
斔	yuwt
愈	yux
愚	yuxb
愉	yuxc
窳	yuxd
窬	yuxe
忬	yuxm
穻	yuxn
悇	yuxo
悆	yuxp
惐	yuxq
慾	yuxr
懙	yuxs
语	yuy
鱼	yuyb
预	yuyc
羽	yuyd
誉	yuye
聿	yuyf
谕	yuyg
谀	yuyh
肀	yuyi
魚	yuym
預	yuyn
語	yuyo
譽	yuyp
諛	yuyq
諭	yuyr
叞	yuys
翑	yuyt
魣	yuyu
羭	yuyv
頨	yuyw
顒	yuyx
鮽	yuyy
謣	yuyz
遇	yuz
逾	yuzb
迂	yuzc
貍	yuzm
込	yuzn
迃	yuzo
逳	yuzp
艅	yuzq
歶	yuzr
雓	yuzs
遹	yuzt
踰	yuzu
貐	yuzv
貗	yuzw
雤	yuzx
鷠	yvnx
鸆	yvny
鸒	yvnz
鯲	yvyv
鰅	yvyw
鱊	yvyx
鱮	yvyy
龥	yvyz
瘾	yxb
寅	yxbb
癮	yxbm
凐	yxbn
瘖	yxbo
癊	yxbp
蚓	yxc
龈	yxcb
齦	yxcm
龂	yxcn
輑	yxco
螾	yxcp
蟫	yxcq
齗	yxcr
殥	yxdm
淫	yxe
湮	yxeb
洇	yxec
洕	yxem
泿	yxen
淾	yxeo
湚	yxep
溵	yxeq
滛	yxer
濦	yxes
濥	yxet
隐	yxf
阴	yxfb
鄞	yxfc
陰	yxfm
隱	yxfn
阥	yxfo
陻	yxfp
隂	yxfq
絪	yxfr
隠	yxfs
緸	yxft
縯	yxfu
引	yxg
靷	yxgm
廕	yxgn
鞇	yxgo
烎	yxhm
秵	yxhn
栶	yxim
梀	yxin
檃	yxio
檭	yxip
檼	yxiq
櫽	yxir
银	yxj
印	yxjb
铟	yxjc
銀	yxjm
銦	yxjn
斦	yxjo
鈝	yxjp
釿	yxjq
鈏	yxjr
裀	yxkm
筃	yxkn
冘	yxmm
骃	yxmn
粌	yxmo
駰	yxmp
闉	yxmq
闇	yxmr
姻	yxn
婬	yxnm
婣	yxnn
鷣	yxno
吟	yxo
喑	yxob
吲	yxoc
唫	yxom
噖	yxon
噾	yxoo
嚚	yxop
殷	yxp
胤	yxpb
乑	yxpm
硍	yxpn
碒	yxpo
磤	yxpp
氤	yxq
狺	yxqb
犾	yxqm
欭	yxqn
酓	yxqo
猌	yxqp
歅	yxqq
酳	yxqr
霪	yxr
朄	yxrm
霒	yxrn
霠	yxro
饮	yxs
飲	yxsm
岃	yxsn
峾	yxso
崟	yxsp
崯	yxsq
飮	yxsr
禋	yxss
嶾	yxst
垠	yxt
堙	yxtb
垔	yxtm
垽	yxtn
堷	yxto
茵	yxu
荫	yxub
茚	yxuc
蔭	yxum
苂	yxun
荶	yxuo
蒑	yxup
蔩	yxuq
蘟	yxur
尹	yxv
伒	yxvm
侌	yxvn
傿	yxvo
因	yxw
囙	yxwm
珢	yxwn
圁	yxwo
璌	yxwp
窨	yxx
夤	yxxb
愔	yxxm
慇	yxxn
慭	yxxo
憖	yxxp
憗	yxxq
懚	yxxr
音	yxy
廴	yxyb
訔	yxym
訚	yxyn
訢	yxyo
訡	yxyp
誾	yxyq
鮣	yxyr
諲	yxys
韾	yxyt
讔	yxyu
夂	yxz
赺	yxzm
趛	yxzn
撄	yya
攖	yyam
摬	yyan
攍	yyao
赢	yyb
瘿	yybb
贏	yybm
癭	yybn
賏	yybo
蝇	yyc
螢	yycm
蠅	yycn
蛍	yyco
蝧	yycp
蝿	yycq
蠳	yycr
滢	yye
瀛	yyeb
潆	yyec
滎	yyem
潁	yyen
瀅	yyeo
瀠	yyep
浧	yyeq
渶	yyer
溁	yyes
溋	yyet
濚	yyeu
濴	yyev
濙	yyew
瀯	yyex
瀴	yyey
灐	yyez
缨	yyf
郢	yyfb
罂	yyfc
纓	yyfm
縈	yyfn
罌	yyfo
耺	yyfp
绬	yyfq
緓	yyfr
縄	yyfs
罃	yyft
应	yyg
鞕	yygm
廮	yygn
荧	yyh
熒	yyhm
穎	yyhn
營	yyho
焸	yyhp
焽	yyhq
煐	yyhr
爃	yyhs
樱	yyi
楹	yyib
櫻	yyim
柍	yyin
桜	yyio
桯	yyip
梬	yyiq
楧	yyir
櫿	yyis
鎣	yyjm
锳	yyjn
覮	yyjo
鐛	yyjp
鑍	yyjq
褮	yykm
籝	yykn
籯	yyko
膺	yyl
媵	yylb
朠	yylm
膡	yyln
盈	yym
盁	yymm
眏	yymn
鹰	yyn
婴	yynb
嬴	yync
鹦	yynd
嬰	yynm
鷹	yynn
鶯	yyno
鸚	yynp
媖	yynq
嫈	yynr
鴬	yyns
鶧	yynt
鶑	yynu
孆	yynv
鷪	yynw
鸎	yynx
嘤	yyo
嚶	yyom
啨	yyon
営	yyoo
噟	yyop
硬	yyp
碤	yypm
礯	yypn
映	yyr
旲	yyrm
暎	yyrn
霙	yyro
影	yys
矨	yysm
嵤	yysn
禜	yyso
巆	yysp
巊	yysq
軈	yysr
塋	yytm
英	yyu
营	yyub
莹	yyuc
莺	yyud
萤	yyue
萦	yyuf
荥	yyug
茔	yyuh
蓥	yyui
萾	yyum
藀	yyun
蘡	yyuo
俓	yyvm
偀	yyvn
僌	yyvo
瑛	yyw
璎	yywb
瑩	yywm
瓔	yywn
珱	yywo
甇	yywp
甖	yywq
應	yyxm
応	yyxn
愥	yyxo
颖	yyy
颍	yyyb
颕	yyym
頴	yyyn
韺	yyyo
謍	yyyp
韹	yyyq
譍	yyyr
譻	yyys
鱦	yyyt
迎	yyz
夃	yyzm
孾	yyzn
齸	yzcz
灜	yzez
黰	yzht
黶	yzhu
穓	yzhv
燚	yzhw
燡	yzhx
燱	yzhy
黳	yzhz
槸	yziw
檍	yzix
檥	yziy
檹	yziz
鏔	yzjx
觺	yzjy
钀	yzjz
鶂	yznn
鶃	yzno
鷊	yznp
鷁	yznq
鷖	yznr
鷧	yzns
鸃	yznt
鷾	yznu
嬿	yznv
鶠	yznw
鷃	yznx
孍	yzny
鷰	yznz
饐	yzsu
巌	yzsv
軅	yzsw
巗	yzsx
巘	yzsy
巚	yzsz
羛	yzyj
詍	yzyk
詑	yzyl
羠	yzym
頉	yzyn
誃	yzyo
頥	yzyp
顊	yzyq
鮧	yzyr
鮨	yzys
謻	yzyt
顗	yzyu
鯣	yzyv
譩	yzyw
譺	yzyx
讉	yzyy
讛	yzyz
扎	zaa
拶	zaab
沞	zaem
沯	zaen
匝	zaf
紮	zafm
紥	zafn
杂	zai
桚	zaim
橴	zain
帀	zajm
鉔	zajn
襍	zakm
臜	zalm
臢	zaln
咋	zao
咂	zaob
喒	zaom
噈	zaon
囃	zaoo
囋	zaop
囐	zaoq
砸	zap
磼	zapm
偺	zavm
韴	zaym
魳	zayn
雜	zazm
雑	zazn
雥	zazo
皂	zcb
皁	zcbm
蚤	zcc
澡	zce
繅	zcfm
繰	zcfn
燥	zch
灶	zchb
煰	zchm
枣	zci
棗	zcim
栆	zcin
梍	zcio
鑿	zcjm
凿	zck
簉	zckm
糟	zcm
噪	zco
唣	zcob
唕	zcom
喿	zcon
醩	zcqm
早	zcr
藻	zcu
薻	zcum
傮	zcvm
璅	zcwm
璪	zcwn
竈	zcxm
慥	zcxn
竃	zcxo
謲	zcym
譟	zcyn
造	zcz
遭	zczb
躁	zczc
艁	zczm
蹧	zczn
趮	zczo
扗	zdam
抂	zdan
宰	zdb
賳	zdbm
载	zdc
載	zdcm
洅	zdem
渽	zden
溨	zdeo
縡	zdfm
灾	zdh
災	zdhm
烖	zdhn
栽	zdi
睵	zdmm
哉	zdo
酨	zdqm
崽	zds
岾	zdsm
在	zdt
再	zdtb
甾	zdtc
畠	zdtm
菑	zdum
仔	zdv
傤	zdvm
儎	zdvn
子	zdz
择	zea
擇	zeam
択	zean
捑	zeao
责	zeb
赜	zebb
責	zebm
賾	zebn
皟	zebo
仄	zec
厠	zecm
蠌	zecn
齚	zeco
齰	zecp
则	zed
則	zedm
泽	zee
澤	zeem
汄	zeen
沢	zeeo
泎	zeep
溭	zeeq
滜	zeer
灂	zees
庂	zegm
稄	zehm
樍	zeim
帻	zej
幘	zejm
笮	zek
箦	zekb
簀	zekm
襗	zekn
耫	zelm
睪	zemm
矠	zemn
瞔	zemo
嫧	zenm
鸅	zenn
啧	zeo
咋	zeob
嘖	zeom
啫	zeon
唶	zeoo
礋	zepm
昃	zer
昗	zerm
崱	zesm
飵	zesn
蔶	zeum
蘀	zeun
侧	zev
側	zevm
伬	zevn
諎	zeym
謮	zeyn
舴	zez
迮	zezb
歵	zezm
揍	zfa
掫	zfam
搊	zfan
齱	zfcm
齺	zfcn
奏	zfd
邹	zff
陬	zffb
鄹	zffc
鄒	zffm
郰	zffn
緅	zffo
楱	zfi
棸	zfim
棷	zfin
箃	zfkm
驺	zfm
騶	zfmm
黀	zfmn
媰	zfnm
菆	zfum
蓙	zfun
偢	zfvm
鲰	zfy
诹	zfyb
諏	zfym
鯫	zfyn
鯐	zfyo
走	zfz
赱	zfzm
撍	zgam
囎	zgom
怎	zgx
谮	zgy
譖	zgym
譛	zgyn
赃	zhb
贓	zhbm
賍	zhbn
賘	zhbo
贜	zhbp
奘	zhd
匨	zhfm
臧	zhg
弉	zhgm
髒	zhgn
欌	zhim
銺	zhjm
脏	zhl
臟	zhlm
臓	zhln
驵	zhm
駔	zhmm
牂	zhpm
塟	zhtm
藏	zhu
葬	zhub
蔵	zhum
羘	zhym
资	zib
兹	zibb
髭	zibc
赀	zibd
資	zibm
貲	zibn
辎	zic
龇	zicb
輜	zicm
齜	zicn
虸	zico
輺	zicp
剚	zidm
鼒	zidn
滋	zie
渍	zieb
淄	ziec
滓	zied
漬	ziem
沝	zien
洓	zieo
湽	ziep
澬	zieq
紫	zif
缁	zifb
緇	zifm
紎	zifn
鄑	zifo
緕	zifp
纃	zifq
秭	zih
秄	zihm
秶	zihn
稵	ziho
穧	zihp
梓	zii
杍	ziim
栥	ziin
椔	ziio
榟	ziip
觜	zij
锱	zijb
錙	zijm
釨	zijn
鈭	zijo
镃	zijp
鍿	zijq
鎡	zijr
笫	zik
耔	zil
胏	zilm
籽	zim
眦	zimb
粢	zimc
眥	zimm
姿	zin
姊	zinb
姉	zinm
姕	zinn
牸	zino
鶅	zinp
呲	zio
吱	ziob
咨	zioc
吇	ziom
呰	zion
啙	zioo
嗞	ziop
嗭	zioq
矷	zipm
齍	ziqm
胾	zirm
胔	zirn
嵫	zis
崰	zism
禌	zisn
畠	zitm
茈	ziu
茲	zium
芓	ziun
茊	ziuo
荢	ziup
茡	ziuq
菑	ziur
葘	zius
蓻	ziut
薋	ziuu
仔	ziv
倳	zivm
璾	ziwm
恣	zix
玆	zixm
谘	ziy
訾	ziyb
鲻	ziyc
諮	ziym
鯔	ziyn
訿	ziyo
頾	ziyp
頿	ziyq
鰦	ziyr
子	ziz
自	zizb
字	zizc
孜	zizd
孳	zize
趑	zizf
孖	zizm
赼	zizn
孶	zizo
趦	zizp
撙	zka
拵	zkam
捘	zkan
尊	zkc
瀳	zkem
罇	zkfm
繜	zkfn
樽	zki
栫	zkim
銌	zkjm
鐏	zkjn
袸	zkkm
鶎	zknm
鷷	zknn
噂	zkom
嶟	zksm
墫	zktm
僔	zkvm
僎	zkvn
鳟	zky
鱒	zkym
譐	zkyn
遵	zkz
跧	zkzm
踆	zkzn
攒	zla
拶	zlab
攢	zlam
揝	zlan
撍	zlao
攅	zlap
赞	zlb
贊	zlbm
寁	zlbn
賛	zlbo
兂	zlem
濽	zlen
灒	zleo
鄼	zlfm
酂	zlfn
酇	zlfo
穳	zlhm
桚	zlim
橵	zlin
錾	zlj
鏨	zljm
鏩	zljn
鐟	zljo
鐕	zljp
篸	zlkm
襸	zlkn
臢	zllm
糌	zlm
鵤	zlnm
咱	zlo
喒	zlom
噆	zlon
囋	zloo
暂	zlr
簪	zlrb
昝	zlrc
暫	zlrm
簮	zlrn
禶	zlsm
饡	zlsn
塹	zltm
偺	zlvm
儧	zlvn
儹	zlvo
瓒	zlw
瓚	zlwm
瓉	zlwn
讃	zlym
讚	zlyn
趱	zlz
趲	zlzm
蹔	zlzn
撮	zoa
捽	zoam
阼	zof
繓	zofm
左	zog
座	zogb
秨	zohm
稓	zohn
穝	zoho
柞	zoi
柮	zoim
椊	zoin
鑿	zojm
鈼	zojn
凿	zok
笮	zokb
袏	zokm
筰	zokn
胙	zol
糳	zomm
唑	zoo
嘬	zoob
咗	zoom
唶	zoon
酢	zoq
昨	zor
祚	zos
岝	zosm
岞	zosn
飵	zoso
坐	zot
苲	zoum
莋	zoun
葃	zouo
葄	zoup
蓙	zouq
作	zov
做	zovb
佐	zovc
侳	zovm
琢	zow
怍	zox
諎	zoym
贼	zpb
賊	zpbm
蠈	zpcm
戝	zpgm
鯽	zpym
鲗	zpyn
鰂	zpyo
鱡	zpyp
攥	zra
揝	zram
赚	zrb
賺	zrbm
劗	zrdm
缵	zrf
纘	zrfm
繤	zrfn
纉	zrfo
欑	zrim
钻	zrj
鉆	zrjm
鑚	zrjn
鑽	zrjo
纂	zrk
篹	zrkm
籫	zrkn
躜	zrz
躦	zrzm
捴	zsam
揌	zsan
揔	zsao
搃	zsap
摠	zsaq
宗	zsb
鬃	zsbb
疭	zsbm
瘲	zsbn
鬉	zsbo
從	zscm
蝬	zscn
潀	zsem
潈	zsen
潨	zseo
综	zsf
纵	zsfb
綜	zsfm
總	zsfn
縱	zsfo
緃	zsfp
総	zsfq
緵	zsfr
緫	zsfs
縂	zsft
縦	zsfu
繌	zsfv
鬷	zsgm
焧	zshm
稯	zshn
熧	zsho
熜	zshp
燪	zshq
棕	zsi
枞	zsib
樅	zsim
椶	zsin
錝	zsjm
鍐	zsjn
鑁	zsjo
腙	zsl
朡	zslm
粽	zsm
骔	zsmm
糉	zsmn
騌	zsmo
騣	zsmp
糭	zsmq
碂	zspm
磫	zspn
猔	zsqm
猣	zsqn
昮	zsrm
嵏	zssm
嵕	zssn
嵸	zsso
豵	zssp
堫	zstm
蓯	zsum
葼	zsun
蓗	zsuo
偬	zsv
傯	zsvm
倊	zsvn
倧	zsvo
总	zsx
惣	zsxm
惾	zsxn
愡	zsxo
翪	zsym
鯮	zsyn
鯼	zsyo
踪	zsz
蹤	zszm
踨	zszn
艐	zszo
组	zuf
阻	zufb
族	zufc
組	zufm
綷	zufn
靻	zugm
租	zuh
稡	zuhm
柤	zuim
椊	zuin
镞	zuj
鏃	zujm
鉐	zujn
鉏	zujo
鎺	zujp
鎐	zujq
箤	zukm
駔	zumm
哫	zuom
唨	zuon
砠	zupm
祖	zus
卒	zusb
卆	zusm
崒	zusn
崪	zuso
菹	zuu
葅	zuum
蒩	zuun
俎	zuv
伜	zuvm
伹	zuvn
倅	zuvo
傶	zuvp
珇	zuwm
怚	zuxm
爼	zuxn
诅	zuy
詛	zuym
謯	zuyn
足	zuz
趲	zuzm
踤	zuzn
踿	zuzo
厜	zvcm
蟕	zvcn
濢	zvem
絊	zvfm
纗	zvfn
稡	zvhm
枠	zvim
栬	zvin
槜	zvio
樶	zvip
檇	zviq
檌	zvir
欈	zvis
觜	zvj
鋷	zvjm
錊	zvjn
脧	zvlm
朘	zvln
冣	zvmm
睟	zvmn
嫢	zvnm
嘴	zvo
咀	zvob
嗺	zvom
噿	zvon
醉	zvq
酔	zvqm
酨	zvqn
酻	zvqo
最	zvr
晬	zvrm
罪	zvs
祽	zvsm
嶊	zvsn
嶉	zvso
嶵	zvsp
蕞	zvu
璻	zvwm
辠	zvxm
赠	zzb
贈	zzbm
综	zzf
缯	zzfb
綜	zzfm
繒	zzfn
鄫	zzfo
縡	zzfp
鬵	zzgm
熷	zzhm
橧	zzim
锃	zzj
鋥	zzjm
竲	zzlm
囎	zzom
磳	zzpm
曾	zzr
曽	zzrm
罾	zzs
矰	zzsm
增	zzt
増	zztm
甑	zzw
璔	zzwm
憎	zzx
譄	zzym
鱛	zzyn
